THEME
space

SIZE
114 71

START
755 200

PAR_TIME
60

PLAYER
monkey

GRAVITY
-1

NEXTMAP
kevin1

TERRAIN
00 00 00 00 00 00 00 00 00 00 00 00 00 00 00 00 00 00 00 00 00 00 00 00 00 00 00 00 00 00 00 00 00 00 00 00 00 00 00 00 00 00 00 00 00 00 00 00 00 00 00 00 00 00 00 00 00 00 00 00 00 00 00 00 00 00 00 00 00 00 00 00 00 00 00 00 00 00 00 00 00 00 00 00 00 00 00 00 00 00 00 00 00 00 00 00 00 00 00 00 00 00 00 00 00 00 00 00 00 00 00 00 00 00 
00 00 00 00 00 00 00 00 00 00 00 00 00 00 00 00 00 19 08 08 08 08 08 08 08 08 08 08 08 08 08 08 08 05 06 00 00 00 00 00 00 00 00 00 00 00 00 00 00 00 00 00 00 00 00 00 00 00 00 00 00 00 00 00 00 00 00 00 00 00 00 00 00 00 00 00 00 00 00 00 00 00 00 00 00 00 00 00 00 00 00 00 00 00 00 00 00 00 00 00 00 00 00 00 00 00 00 00 00 00 00 00 00 00 
00 00 00 00 00 00 00 00 00 00 00 00 00 00 19 08 08 20 15 15 15 15 15 15 15 15 15 15 15 15 15 15 15 15 17 08 08 18 00 00 00 00 00 00 00 00 00 00 00 00 19 08 08 08 08 08 08 08 08 05 06 00 00 00 03 04 08 08 08 08 08 08 08 08 05 06 00 00 00 00 00 00 00 00 00 00 00 00 00 00 00 00 00 00 00 00 00 00 00 00 00 00 00 00 00 00 00 00 00 00 00 00 00 00 
00 00 00 00 00 00 00 00 00 00 03 33 04 08 20 15 15 15 15 10 22 22 26 30 30 30 30 30 25 13 15 15 15 15 15 15 15 17 08 08 08 08 08 08 08 08 08 08 08 08 20 15 15 15 15 15 15 15 15 15 17 08 08 08 20 15 15 15 15 15 15 15 15 15 15 17 08 08 08 08 08 08 08 05 06 00 00 00 00 00 00 00 00 00 00 00 00 00 00 00 00 00 00 00 00 00 00 00 00 00 00 00 00 00 
00 00 00 00 00 00 00 19 08 08 20 15 15 15 15 15 15 15 10 11 00 00 00 00 00 00 00 00 00 12 13 15 15 15 15 15 15 15 15 15 15 15 15 15 15 15 15 15 15 15 15 15 15 15 15 15 15 15 15 15 15 15 15 15 15 15 15 15 15 15 15 15 15 15 15 15 15 15 15 15 15 15 15 15 17 08 08 08 08 18 00 00 00 00 00 00 00 00 00 00 00 00 00 00 00 00 00 00 00 00 00 00 00 00 
00 00 00 00 00 00 28 20 15 15 15 15 15 15 15 15 15 10 11 00 00 00 00 00 00 00 00 00 00 00 14 15 15 15 15 10 22 22 13 15 15 15 15 15 15 15 15 15 15 15 15 15 15 15 15 15 15 15 15 15 15 15 15 15 10 22 13 15 15 15 15 15 15 15 15 15 15 15 15 15 15 15 15 15 15 15 15 15 15 17 05 06 00 00 00 00 00 00 00 00 00 00 00 00 00 00 00 00 00 00 00 00 00 00 
00 00 00 00 00 00 35 15 15 15 15 15 15 15 15 15 15 43 00 00 00 00 00 00 00 00 00 00 00 28 20 15 15 15 10 11 00 00 24 30 25 22 22 22 22 13 15 15 15 15 15 15 15 15 15 15 15 15 15 10 22 22 22 26 27 00 24 25 13 15 15 15 15 15 15 15 10 22 13 15 15 15 15 15 15 15 15 15 15 15 15 17 05 06 00 00 00 00 00 00 00 00 00 00 00 00 00 00 00 00 00 00 00 00 
00 00 00 00 03 04 20 15 15 15 15 15 15 15 15 15 10 50 00 00 00 00 00 00 00 00 00 00 00 35 15 15 15 15 16 00 00 00 00 00 00 00 00 00 00 24 25 22 22 22 22 22 22 22 22 22 22 22 26 27 00 00 00 00 00 00 00 00 12 13 15 15 15 15 15 10 11 00 12 22 13 15 15 15 15 15 15 15 15 15 15 15 15 17 08 05 33 04 08 08 18 00 00 00 00 00 00 00 00 00 00 00 00 00 
00 00 00 00 14 15 15 15 15 15 15 15 15 10 22 22 11 00 00 00 00 00 00 00 00 00 00 00 19 20 15 15 15 15 43 00 00 00 00 00 00 00 00 00 00 00 00 00 00 00 00 00 00 00 00 00 00 00 00 00 00 00 00 00 00 00 00 00 00 12 13 15 15 15 15 43 00 00 00 00 12 13 15 15 15 15 15 15 15 15 15 15 15 15 15 15 15 15 15 15 17 08 18 00 00 00 00 00 00 00 00 00 00 00 
00 00 00 28 20 15 15 15 15 15 15 15 10 11 00 00 00 00 00 00 00 00 00 00 00 00 03 04 20 15 15 15 15 10 50 00 00 00 00 00 00 00 00 00 00 00 00 00 00 00 00 00 00 00 00 00 00 00 00 00 00 00 00 00 00 00 00 00 00 00 12 13 15 15 10 50 00 00 00 00 00 14 15 15 15 15 10 26 25 13 15 15 15 15 15 15 15 15 15 15 15 15 17 05 06 00 00 00 00 00 00 00 00 00 
00 00 00 35 15 15 15 15 15 15 15 15 16 00 00 00 00 00 00 00 00 00 00 00 03 04 20 15 15 15 15 10 26 27 00 00 00 00 00 00 00 00 00 00 00 00 00 00 00 00 00 00 00 00 00 00 00 00 00 00 00 00 00 00 00 00 00 00 00 00 00 12 22 22 11 00 00 00 00 00 00 42 15 15 15 15 43 00 00 24 30 30 30 25 22 13 15 15 15 15 15 15 15 15 17 05 06 00 00 00 00 00 00 00 
00 00 00 14 15 15 15 15 15 15 15 15 43 00 00 00 00 00 00 00 00 00 00 19 20 15 15 15 10 26 30 27 00 00 00 00 00 00 00 00 00 00 00 00 00 00 00 00 00 00 00 00 00 00 00 00 00 00 00 00 00 00 00 00 00 00 00 00 00 00 00 00 00 00 00 00 00 00 00 00 00 49 13 15 15 10 50 00 00 00 00 00 00 00 00 24 25 13 15 15 15 15 15 15 15 15 17 18 00 00 00 00 00 00 
00 00 00 14 15 15 15 15 15 15 15 10 50 00 00 00 00 00 00 00 00 00 28 20 15 15 15 10 11 00 00 00 00 00 00 00 00 00 00 00 00 00 00 00 00 00 00 00 00 00 00 00 00 00 00 00 00 00 00 00 00 00 00 00 00 00 00 00 00 00 00 00 00 00 00 00 00 00 00 00 00 00 14 15 15 17 18 00 00 00 00 00 00 00 00 00 00 12 13 15 15 15 15 15 15 15 15 17 18 00 00 00 00 00 
00 00 00 14 15 15 15 15 15 15 15 16 00 00 00 00 00 00 00 00 00 00 35 15 15 15 10 11 00 00 00 00 00 00 00 00 00 00 00 00 00 00 00 00 00 00 00 00 00 00 00 00 00 00 00 00 00 00 00 00 00 00 00 00 00 00 00 00 00 00 00 00 00 00 00 00 00 00 00 00 00 00 14 15 15 15 17 08 18 00 00 00 00 00 00 00 00 00 24 25 13 15 15 15 15 15 15 15 16 00 00 00 00 00 
00 00 19 20 15 15 15 15 15 15 15 16 00 00 00 00 00 00 00 00 00 00 12 13 15 10 11 00 00 00 00 00 00 00 00 00 00 00 00 00 00 00 00 00 00 00 00 00 00 00 00 00 00 00 00 00 00 00 00 00 00 00 00 00 00 00 00 00 00 00 00 28 08 08 29 00 00 00 00 00 00 00 12 22 13 15 15 15 17 18 00 00 00 00 00 00 00 00 00 00 12 13 15 15 15 15 15 15 16 00 00 00 00 00 
00 00 14 15 15 15 15 15 15 15 15 43 00 00 00 00 00 00 00 00 00 00 00 24 25 11 00 00 00 00 00 00 00 00 00 00 00 00 00 00 00 00 00 00 00 00 00 00 00 00 00 00 00 00 00 00 00 00 00 00 00 00 00 00 00 00 00 00 00 00 00 35 15 15 36 00 00 00 00 00 00 00 00 00 24 25 13 15 15 17 05 06 00 00 00 00 00 00 00 00 00 24 25 13 15 15 15 15 16 00 00 00 00 00 
00 00 14 15 15 15 15 15 15 15 10 50 00 00 00 00 00 00 00 00 00 00 00 00 00 00 00 00 00 00 00 00 00 00 00 00 00 00 00 00 00 00 00 00 00 00 00 00 00 00 00 00 00 00 00 00 00 00 00 00 00 00 00 00 00 00 00 00 00 00 19 20 15 15 16 00 00 00 00 00 00 00 00 00 00 00 42 15 15 15 15 17 18 00 00 00 00 00 00 00 00 00 00 12 13 15 15 15 16 00 00 00 00 00 
00 28 20 15 15 15 15 15 15 15 16 00 00 00 00 00 00 00 00 00 00 00 00 00 00 00 00 00 00 00 00 00 00 00 00 00 00 00 00 00 00 00 00 00 00 00 00 00 00 03 04 08 08 08 18 00 00 00 00 00 00 00 00 00 00 00 00 00 00 19 20 15 15 15 17 29 00 00 00 00 00 00 00 00 00 00 49 13 15 15 15 15 17 18 00 00 00 00 00 00 00 00 00 00 42 15 15 15 17 29 00 00 00 00 
00 35 15 15 15 15 15 15 15 15 16 00 00 00 00 00 00 00 00 00 00 00 00 00 00 00 00 00 00 00 00 00 00 00 00 00 00 00 00 00 00 00 00 00 00 03 33 04 08 20 15 15 15 15 17 05 06 00 00 00 00 00 00 00 00 00 00 03 04 20 15 15 15 15 15 36 00 00 00 00 00 00 00 00 00 00 00 12 13 15 15 15 15 17 18 00 00 00 00 00 00 00 00 00 49 13 15 15 15 36 00 00 00 00 
00 14 15 15 15 15 15 15 15 15 16 00 00 00 00 00 00 00 00 00 00 00 00 00 00 00 00 00 00 00 00 00 00 00 00 00 00 00 00 00 00 00 03 33 04 20 15 15 15 15 15 15 15 15 15 15 17 18 00 00 00 00 00 03 33 04 08 20 15 15 15 15 15 15 15 17 18 00 00 00 00 00 00 00 00 00 00 00 24 25 13 15 15 15 16 00 00 00 00 00 00 00 00 00 00 12 13 15 15 17 29 00 00 00 
00 14 15 15 15 15 15 15 15 15 16 00 00 00 00 00 00 00 00 00 00 00 00 00 00 00 00 00 00 00 00 00 00 00 00 00 00 00 00 00 03 04 20 15 15 15 15 15 15 15 15 15 15 15 15 15 15 17 18 00 00 00 19 20 15 15 15 15 15 15 15 15 15 15 15 15 17 18 00 00 00 00 00 00 00 00 00 00 00 00 12 13 15 15 17 29 00 00 00 00 00 00 00 00 00 00 42 15 15 15 36 00 00 00 
00 14 15 15 15 15 15 15 15 15 16 00 00 00 00 00 00 00 00 00 00 00 00 00 00 00 00 00 00 00 00 00 00 00 00 00 00 00 03 04 20 15 15 15 15 15 15 15 15 15 15 15 10 22 22 22 22 22 11 00 00 00 12 22 13 15 15 15 15 15 15 15 15 15 15 15 15 17 05 33 06 00 00 00 00 00 00 00 00 00 00 42 15 15 15 36 00 00 00 00 00 00 00 00 00 00 49 13 15 15 16 00 00 00 
00 12 13 15 15 15 15 15 15 15 16 00 00 00 00 00 00 00 00 00 00 00 00 00 00 00 00 00 00 00 00 00 00 00 00 00 19 08 20 15 15 15 15 15 15 15 10 22 22 22 26 30 27 00 00 00 00 00 00 00 00 00 00 00 24 25 13 15 15 15 15 15 15 15 15 15 15 15 15 15 17 05 33 33 06 00 00 00 00 00 00 31 15 15 15 16 00 00 00 00 00 00 00 00 00 00 00 14 15 15 17 29 00 00 
00 00 14 15 15 15 15 15 15 15 16 00 00 00 00 00 00 00 00 00 00 00 00 00 00 00 00 00 00 00 00 00 00 00 03 04 20 15 15 15 15 15 15 15 10 26 27 00 00 00 00 00 00 00 00 00 00 00 00 00 00 00 00 00 00 00 42 15 15 15 15 15 15 15 15 15 15 15 15 15 15 15 15 15 17 29 00 00 00 00 00 35 15 15 15 16 00 00 00 00 00 00 00 00 00 00 00 14 15 15 15 36 00 00 
00 00 14 15 15 15 15 15 15 15 16 00 00 00 00 00 00 00 00 00 00 00 00 00 00 00 00 00 00 00 00 00 00 00 14 15 15 15 15 15 15 15 15 10 11 00 00 00 00 00 00 00 00 00 00 00 00 00 00 00 00 00 00 00 00 00 49 13 15 15 15 15 15 15 15 15 15 15 15 15 15 15 15 15 15 36 00 00 00 00 28 20 15 15 15 16 00 00 00 00 00 00 00 00 00 00 00 14 15 15 15 16 00 00 
00 00 14 15 15 15 15 15 15 15 43 00 00 00 00 00 00 00 00 00 00 00 00 00 00 00 00 00 00 00 00 00 00 00 14 15 15 15 15 15 15 15 15 43 00 00 00 00 00 00 00 00 00 00 00 00 00 00 00 00 00 00 00 00 00 00 00 42 15 15 10 22 13 15 15 15 15 15 15 15 15 15 15 15 15 17 18 00 00 00 35 15 15 15 15 17 29 00 00 00 00 00 00 00 00 00 00 12 22 22 22 23 00 00 
00 00 12 13 15 15 15 15 15 15 32 00 00 00 00 00 00 00 00 00 00 00 00 00 00 00 00 00 00 00 00 00 00 00 12 13 15 15 15 15 15 15 10 50 00 00 00 00 00 00 00 00 00 00 00 00 00 00 00 00 00 00 00 00 00 00 00 49 22 22 11 00 12 13 15 15 15 15 15 15 15 15 15 15 15 15 16 00 00 00 14 15 15 15 15 15 36 00 00 00 00 00 00 00 00 00 00 00 00 00 00 52 00 00 
00 00 00 42 15 15 15 15 15 15 32 00 00 00 00 00 00 00 00 00 00 00 00 00 00 00 00 00 00 00 00 00 00 00 00 12 13 15 15 15 15 15 16 00 00 00 00 00 00 00 00 00 00 00 00 00 00 00 00 00 00 00 00 00 00 00 00 00 00 00 00 00 00 12 13 15 10 22 22 22 13 15 15 15 15 10 11 00 00 00 12 13 15 15 15 15 17 29 00 00 00 00 00 00 00 00 00 00 00 00 00 52 00 00 
00 00 00 49 13 15 15 15 15 10 50 00 00 00 00 00 00 00 00 00 00 00 00 00 00 00 00 00 00 00 00 00 00 00 00 00 42 15 15 15 15 15 17 18 00 00 00 00 00 00 00 00 00 00 00 00 00 00 00 00 00 00 00 00 00 00 00 00 00 00 00 00 00 00 24 30 27 00 00 00 24 30 25 22 26 27 00 00 00 00 00 42 15 15 15 15 15 36 00 00 00 00 00 00 00 00 00 00 00 00 00 52 00 00 
00 00 00 00 14 15 15 15 15 16 00 00 00 00 00 00 00 00 00 00 00 00 00 00 00 00 00 00 00 00 00 00 00 00 00 00 49 13 15 15 15 15 15 17 05 06 00 00 00 00 00 00 00 00 00 00 00 00 00 00 00 00 00 00 00 00 00 00 00 00 00 00 00 00 00 00 00 00 00 00 00 00 00 00 00 00 00 00 00 00 00 49 13 15 15 15 15 16 00 00 00 00 00 00 00 00 00 19 08 08 08 09 00 00 
00 00 00 00 12 13 15 15 15 17 29 00 00 00 00 00 00 00 00 00 00 00 00 00 00 00 00 00 00 00 00 00 00 00 00 00 00 42 15 15 15 15 15 15 15 17 18 00 00 00 00 00 00 00 00 00 00 00 00 00 00 00 00 00 00 00 00 00 07 08 29 00 00 00 00 00 00 00 00 00 00 00 00 00 00 00 00 00 00 00 00 00 42 15 15 15 15 16 00 00 00 00 00 00 00 00 00 14 15 15 15 16 00 00 
00 00 00 00 00 12 13 15 15 15 36 00 00 00 00 00 00 00 00 00 00 00 00 00 00 00 00 00 00 00 00 00 00 00 00 00 00 49 13 15 15 15 15 15 15 15 17 18 00 00 00 00 00 00 00 00 00 00 00 00 00 00 00 00 00 00 00 00 14 15 36 00 00 00 00 00 00 00 00 00 00 00 00 00 00 00 00 00 00 00 00 00 49 13 15 15 10 11 00 00 00 00 00 00 00 00 00 14 15 15 15 16 00 00 
00 00 00 00 00 19 20 15 15 15 17 18 00 00 00 00 00 00 00 00 00 00 00 00 00 00 00 00 00 00 00 00 00 00 00 00 00 00 42 15 15 15 15 15 15 15 15 17 08 08 08 08 05 06 00 00 00 00 00 00 00 00 00 00 00 00 00 19 20 15 17 18 00 00 00 00 00 00 00 00 00 00 00 00 00 00 00 00 00 00 00 00 00 12 22 22 11 00 00 00 00 00 00 00 00 00 00 14 15 15 15 16 00 00 
00 00 00 00 19 20 15 15 15 15 15 17 18 00 00 00 00 00 00 00 00 00 00 00 00 00 00 00 00 00 00 00 00 00 00 00 00 00 49 22 22 22 13 15 15 15 15 15 15 15 15 15 15 17 08 08 18 00 00 00 00 00 00 00 00 00 19 20 15 15 15 17 05 06 00 00 00 00 00 00 00 00 00 00 00 00 00 00 00 00 00 00 00 00 00 00 00 00 00 00 00 00 00 00 00 00 00 14 15 15 15 16 00 00 
00 00 00 19 20 15 15 15 15 15 15 15 17 05 06 00 00 00 00 00 00 00 00 00 00 00 00 00 00 00 00 00 00 00 00 00 00 00 00 00 00 00 24 25 13 15 15 15 15 15 15 15 15 15 15 15 17 05 06 00 00 00 19 08 08 08 20 15 15 15 15 15 15 17 05 06 00 00 00 00 00 00 00 00 00 00 00 00 00 00 00 00 00 00 00 00 00 00 00 00 00 00 00 00 00 00 00 14 15 15 15 16 00 00 
00 00 00 14 15 15 15 15 15 15 15 15 15 15 17 05 06 00 00 00 00 00 00 00 00 00 00 00 00 00 19 08 08 05 06 00 00 00 00 00 00 00 00 00 42 15 15 15 15 15 15 15 15 15 15 15 15 10 11 00 00 00 42 15 15 15 15 15 15 15 15 15 15 15 15 17 05 06 00 00 00 00 00 00 00 00 00 00 00 00 00 00 00 00 00 00 00 00 00 00 00 00 00 00 00 00 00 14 15 15 15 43 00 00 
00 00 00 14 15 15 15 15 15 15 15 15 15 15 15 15 17 05 06 00 00 00 00 00 00 00 00 00 00 28 20 15 15 15 17 18 00 00 00 00 00 00 00 00 49 13 15 15 15 15 15 15 15 15 15 10 26 27 00 00 00 00 49 22 13 15 15 15 15 15 15 15 15 15 15 15 15 17 08 05 06 00 00 00 00 00 00 00 00 00 00 00 00 00 00 03 33 06 00 00 00 00 00 00 00 00 00 14 15 15 10 50 00 00 
00 00 19 20 15 15 15 15 15 15 15 15 15 15 15 15 15 15 17 18 00 00 00 00 00 00 00 00 00 35 15 15 15 15 15 17 08 08 08 08 29 00 00 00 00 12 13 15 15 15 15 15 15 10 26 27 00 00 00 00 00 00 00 00 24 25 22 13 15 15 15 15 15 15 15 15 15 15 15 15 17 18 00 00 00 00 00 00 00 00 00 00 03 04 08 20 15 17 29 00 00 00 00 00 00 00 19 20 15 15 43 00 00 00 
00 00 14 15 15 15 15 15 15 15 15 15 15 15 15 15 15 15 15 17 05 06 00 00 00 00 00 00 19 20 15 15 15 15 15 15 15 15 15 15 36 00 00 00 00 00 42 15 15 15 15 15 10 11 00 00 00 00 00 00 00 00 00 00 00 00 00 12 13 15 15 15 15 15 15 15 15 15 15 15 15 16 00 00 00 00 00 00 00 00 03 04 20 15 15 15 15 15 36 00 00 00 00 00 00 00 14 15 15 15 32 00 00 00 
00 00 42 15 15 15 15 15 15 15 15 15 15 10 22 13 15 15 15 15 15 17 08 08 09 00 00 00 14 15 15 15 15 15 15 15 15 15 15 15 16 00 00 00 00 00 49 13 15 15 15 15 43 00 00 00 00 00 00 00 00 00 00 00 00 00 00 00 49 13 15 15 15 15 15 15 15 15 15 15 15 17 29 00 00 28 08 08 08 08 20 15 15 15 15 15 15 15 16 00 00 00 00 00 00 00 12 13 15 15 36 00 00 00 
00 00 49 13 15 15 15 15 15 15 15 10 26 27 00 24 25 13 15 15 15 15 15 15 43 00 00 00 12 13 15 15 15 15 15 15 15 15 15 15 16 00 00 00 00 00 00 12 13 15 15 15 32 00 00 00 00 00 00 00 00 00 00 00 00 00 00 00 00 42 15 15 15 15 15 15 15 15 15 15 15 15 32 00 00 31 15 15 15 15 15 15 15 15 15 15 15 15 17 29 00 00 00 00 00 00 00 14 15 15 16 00 00 00 
00 00 00 14 15 15 15 15 15 10 26 27 00 00 00 00 00 12 13 15 15 15 15 10 50 00 00 00 00 12 13 15 15 15 15 15 15 15 15 10 11 00 00 00 00 00 00 00 42 15 15 15 36 00 00 00 00 00 00 00 00 00 00 00 00 00 00 00 00 49 13 15 15 15 15 15 15 15 15 15 15 10 50 00 00 49 13 15 15 15 15 15 15 15 15 15 15 15 15 36 00 00 00 00 00 00 00 14 15 15 16 00 00 00 
00 00 00 14 15 15 15 10 26 27 00 00 00 00 00 00 00 00 42 15 15 15 15 16 00 00 00 00 00 00 12 13 15 15 15 15 15 10 26 27 00 00 00 00 00 00 00 00 31 15 15 15 17 18 00 00 00 00 00 00 00 00 00 00 00 00 00 00 00 00 12 13 15 15 15 15 15 15 15 15 15 43 00 00 00 00 12 13 15 15 15 15 15 15 15 15 15 15 15 16 00 00 00 00 00 00 00 14 15 15 16 00 00 00 
00 00 19 20 15 15 10 11 00 00 00 00 00 00 00 00 00 00 49 13 15 15 15 17 29 00 00 00 00 00 00 24 25 22 22 22 26 27 00 00 00 00 00 00 00 00 00 00 31 15 15 15 15 17 18 00 00 00 00 00 00 00 00 00 00 00 00 00 00 00 00 12 13 15 15 15 15 15 15 15 10 50 00 00 00 00 00 42 15 15 15 15 15 15 15 15 15 10 26 27 00 00 00 00 00 00 28 20 15 15 16 00 00 00 
00 00 14 15 15 15 16 00 00 00 00 00 00 00 00 00 00 00 00 12 13 15 15 15 36 00 00 00 00 00 00 00 00 00 00 00 00 00 00 00 00 00 00 00 00 00 00 00 31 15 15 15 15 15 17 18 00 00 00 00 00 00 00 00 00 00 00 00 00 00 00 00 24 25 13 15 15 10 22 26 27 00 00 00 00 00 00 49 13 15 15 15 15 15 15 15 10 11 00 00 00 00 00 00 00 00 35 15 15 15 16 00 00 00 
00 19 20 15 15 15 16 00 00 00 00 00 00 00 00 00 00 00 00 00 42 15 15 15 17 29 00 00 00 00 00 00 00 00 00 00 00 00 00 00 00 00 00 00 00 00 00 00 35 15 15 15 15 15 15 17 18 00 00 00 00 00 00 00 00 00 00 00 00 00 00 00 00 00 12 22 26 27 00 00 00 00 00 00 00 00 00 00 12 13 15 15 15 15 15 15 43 00 00 00 00 00 00 00 00 00 14 15 15 15 17 18 00 00 
00 14 15 15 15 15 17 29 00 00 00 00 00 00 00 00 00 00 00 00 49 13 15 15 15 36 00 00 00 00 00 00 00 00 00 00 00 00 00 00 00 00 00 00 00 03 33 04 20 15 15 15 15 15 15 15 17 05 06 00 00 00 00 00 00 00 00 00 00 00 00 00 00 00 00 00 00 00 00 00 00 00 00 00 00 00 00 00 00 12 13 15 15 15 15 15 36 00 00 00 00 00 00 00 00 00 14 15 15 15 15 16 00 00 
00 14 15 15 15 15 15 36 00 00 00 00 00 00 00 00 00 00 00 00 00 12 13 15 15 17 18 00 00 00 00 00 00 00 00 00 00 00 00 00 00 00 00 03 04 20 15 15 15 15 15 15 15 15 15 15 15 15 17 18 00 00 00 00 00 00 00 00 00 00 00 00 00 00 00 00 00 00 00 00 00 00 00 00 00 00 00 00 00 00 12 13 15 15 15 15 17 29 00 00 00 00 00 00 00 00 14 15 15 15 15 43 00 00 
00 14 15 15 15 15 15 17 18 00 00 00 00 00 00 00 00 00 00 00 00 00 12 13 15 15 17 29 00 00 00 00 00 00 00 00 00 00 00 00 00 03 04 20 15 15 15 15 15 15 10 22 22 13 15 15 15 15 15 17 18 00 00 00 00 00 00 00 00 00 00 00 00 00 00 00 00 00 00 00 00 00 00 00 00 00 00 00 00 00 00 12 13 15 15 15 15 36 00 00 00 00 00 00 00 00 14 15 15 15 10 50 00 00 
00 12 13 15 15 15 15 15 17 18 00 00 00 00 00 00 00 00 00 00 00 00 00 12 13 15 15 36 00 00 00 00 00 03 04 08 08 08 08 08 08 20 15 15 15 15 15 15 10 22 11 00 00 12 13 15 15 15 15 15 17 29 00 00 00 00 00 00 00 00 00 00 00 00 00 00 00 00 00 00 00 00 00 00 00 00 00 00 00 00 00 00 12 13 15 15 15 17 05 06 00 00 00 00 00 28 20 15 15 15 16 00 00 00 
00 00 14 15 15 15 15 15 15 17 18 00 00 00 00 00 00 00 00 00 00 00 00 00 12 13 15 17 08 18 00 00 19 20 15 15 15 15 15 15 15 15 15 15 15 15 10 26 27 00 00 00 00 00 12 22 13 15 15 15 15 36 00 00 00 00 00 00 00 00 00 00 00 00 00 00 00 00 00 00 00 00 00 00 00 00 00 00 00 00 00 00 00 12 13 15 15 15 15 17 18 00 00 00 00 35 15 15 15 15 16 00 00 00 
00 00 42 15 15 15 15 15 15 15 17 18 00 00 00 00 00 00 00 00 00 00 00 00 00 12 13 15 15 17 08 08 20 15 15 15 15 15 15 15 15 15 15 15 15 15 16 00 00 00 00 00 00 00 00 00 12 13 15 15 15 17 05 06 00 00 00 00 00 00 00 00 00 00 00 00 00 00 00 00 00 00 00 00 00 00 00 00 00 00 00 00 00 00 12 13 15 15 15 15 17 05 06 00 19 20 15 15 15 15 16 00 00 00 
00 00 31 15 15 15 15 15 15 15 15 17 29 00 00 00 00 00 00 00 00 00 00 00 00 00 12 13 15 15 15 15 15 15 15 15 15 15 15 15 15 15 15 15 15 15 17 29 00 00 00 00 00 00 00 00 00 12 13 15 15 15 15 17 18 00 00 00 00 00 00 00 00 00 00 00 00 00 00 00 00 00 00 00 00 00 00 00 00 00 00 00 00 00 00 12 13 15 15 15 15 15 17 08 20 15 15 15 15 10 11 00 00 00 
00 00 49 13 15 15 15 15 15 15 15 15 36 00 00 00 00 00 00 00 00 00 00 00 00 00 00 12 22 22 22 22 26 30 30 30 30 30 25 22 22 13 15 15 15 15 15 36 00 00 00 00 00 00 00 00 00 00 14 15 15 15 15 15 17 18 00 00 00 00 00 00 00 00 00 00 00 00 00 00 00 00 00 00 00 00 00 00 00 00 00 00 00 00 00 00 12 13 15 15 15 15 15 15 15 15 15 15 15 17 29 00 00 00 
00 00 00 12 13 15 15 15 15 15 15 15 17 08 08 05 06 00 00 00 00 00 00 00 00 00 00 00 00 00 00 00 00 00 00 00 00 00 00 00 00 12 13 15 15 15 15 17 08 18 00 00 00 00 00 00 00 28 20 15 15 15 15 15 15 17 08 18 00 00 00 00 00 00 00 00 00 00 00 00 00 00 00 00 00 00 00 00 00 00 00 00 00 00 00 00 00 42 15 15 15 15 15 15 15 15 15 15 15 15 36 00 00 00 
00 00 00 00 12 13 15 15 15 15 15 15 15 15 15 15 17 08 05 06 00 00 00 00 00 00 00 00 00 00 00 00 00 00 00 00 00 00 00 00 00 00 12 13 15 15 15 15 15 17 08 05 06 00 00 00 00 35 15 15 15 15 15 15 15 15 15 17 18 00 00 00 00 00 00 00 00 00 00 00 00 00 00 00 00 00 00 00 00 00 00 00 00 00 00 00 00 49 13 15 15 15 15 15 15 15 15 15 15 15 17 29 00 00 
00 00 00 00 00 24 30 25 13 15 15 15 15 15 15 15 15 15 15 17 08 18 00 00 00 00 00 00 00 00 00 00 00 00 00 00 00 00 00 00 00 00 00 24 25 13 15 15 15 15 15 15 17 09 00 00 00 14 15 15 15 15 15 10 22 22 22 13 17 08 08 05 06 00 00 00 00 00 00 00 00 00 00 00 00 00 00 00 00 00 00 00 00 00 00 00 00 00 42 15 15 15 15 15 15 15 15 15 15 15 15 36 00 00 
00 00 00 00 00 00 00 00 24 25 13 15 15 15 15 15 15 15 15 15 15 17 05 06 00 00 00 19 08 08 29 00 00 00 00 00 00 00 00 00 00 00 00 00 00 24 30 30 25 22 22 22 22 11 00 00 00 12 22 22 22 22 22 11 00 00 00 12 22 13 15 15 17 05 06 00 00 00 00 00 00 00 00 00 00 00 00 00 00 00 00 00 00 00 00 00 00 00 49 13 15 15 15 15 15 15 15 15 15 15 15 17 29 00 
00 00 00 00 00 00 00 00 00 00 12 13 15 15 15 15 15 15 15 15 15 15 15 17 08 08 08 20 15 15 36 00 00 00 00 00 00 00 00 00 00 00 00 00 00 00 00 00 00 00 00 00 00 00 00 00 00 00 00 00 00 00 00 00 00 00 00 00 00 24 25 22 22 22 23 00 00 00 00 00 00 00 00 00 00 00 00 00 00 00 00 00 00 00 00 00 00 00 00 42 15 15 15 15 15 15 15 15 15 15 15 15 36 00 
00 00 00 00 00 00 00 00 00 00 00 24 25 22 22 22 13 15 15 15 15 15 15 15 15 15 15 15 15 15 17 05 06 00 00 00 00 00 00 00 00 00 00 00 00 00 00 00 00 00 00 00 00 00 00 00 00 00 00 00 00 00 00 00 00 00 00 00 00 00 00 00 00 00 00 00 00 00 00 00 00 00 00 00 00 00 00 00 00 00 00 00 00 00 00 00 00 00 00 49 13 15 15 15 15 15 15 15 15 15 15 15 16 00 
00 00 00 00 00 00 00 00 00 00 00 00 00 00 00 00 24 25 22 22 22 13 15 15 15 15 15 15 15 15 15 15 17 08 08 08 18 00 00 00 00 00 00 00 00 00 00 00 00 00 00 00 00 00 00 00 00 00 00 00 00 00 00 00 00 00 00 00 00 00 00 00 00 00 00 00 00 00 00 00 00 00 00 00 00 00 00 00 00 00 00 00 00 00 00 00 00 00 00 00 14 15 15 15 15 15 15 15 15 15 15 15 16 00 
00 00 00 00 00 00 00 00 00 00 00 00 00 00 00 00 00 00 00 00 00 24 30 30 25 13 15 15 15 15 15 15 15 15 15 15 17 08 08 18 00 00 00 00 00 00 00 00 00 00 00 00 00 00 00 00 00 00 00 00 00 00 00 00 00 00 00 00 00 00 00 00 00 00 00 00 00 00 00 00 00 00 00 00 00 00 00 00 00 00 00 00 00 00 00 00 00 00 00 19 20 15 15 15 15 15 15 15 15 15 15 15 16 00 
00 00 00 00 00 00 00 00 00 00 00 00 00 00 00 00 00 00 00 00 00 00 00 00 00 12 22 13 15 15 15 15 15 15 15 15 15 15 15 17 18 00 00 00 00 00 00 00 00 00 00 00 00 00 00 00 00 00 00 00 00 00 00 00 00 00 00 00 00 00 00 00 03 04 08 08 08 08 08 05 06 00 00 00 00 00 00 19 08 08 08 08 05 33 06 00 00 00 19 20 15 15 15 15 15 15 15 15 15 15 15 15 16 00 
00 00 00 00 00 00 00 00 00 00 00 00 00 00 00 00 00 00 00 00 00 00 00 00 00 00 00 24 25 13 15 15 15 15 15 15 15 15 15 15 17 08 05 06 00 00 00 00 00 00 00 00 00 00 00 00 00 00 00 00 00 00 00 00 00 00 00 00 00 03 04 08 20 15 15 15 15 15 15 15 17 05 06 00 00 00 19 20 15 15 15 15 15 15 17 05 33 04 20 15 15 15 15 15 15 15 15 15 15 15 15 15 43 00 
00 00 00 00 00 00 00 00 00 00 00 00 00 00 00 00 00 00 00 00 00 00 00 00 00 00 00 00 00 24 25 22 13 15 15 15 15 15 15 15 15 15 15 17 08 08 08 08 08 08 08 05 06 00 00 00 00 00 00 00 00 00 00 00 00 00 00 00 19 20 15 15 15 15 15 15 15 15 15 15 15 15 17 08 08 08 20 15 15 15 15 15 15 15 15 15 15 15 15 15 15 15 15 15 15 15 15 15 15 15 15 10 50 00 
00 00 00 00 00 00 00 00 00 00 00 00 00 00 00 00 00 00 00 00 00 00 00 00 00 00 00 00 00 00 00 00 24 30 25 22 13 15 15 15 15 15 15 15 15 15 15 15 15 15 15 15 17 08 08 08 08 08 08 05 06 00 00 00 03 04 08 08 20 15 15 15 15 10 22 22 22 22 13 15 15 15 15 15 15 15 15 15 15 15 15 15 15 15 15 15 15 15 15 15 15 15 15 15 15 15 15 15 15 15 10 11 00 00 
00 00 00 00 00 00 00 00 00 00 00 00 00 00 00 00 00 00 00 00 00 00 00 00 00 00 00 00 00 00 00 00 00 00 00 00 24 30 30 25 22 22 22 22 22 22 22 22 22 22 13 15 15 15 15 15 15 15 15 15 17 08 08 08 20 15 15 15 10 22 22 22 26 27 00 00 00 00 12 13 15 15 15 15 15 15 15 15 15 15 10 22 22 22 22 13 15 15 15 15 15 15 15 15 15 15 15 15 10 26 27 00 00 00 
00 00 00 00 00 00 00 00 00 00 00 00 00 00 00 00 00 00 00 00 00 00 00 00 00 00 00 00 00 00 00 00 00 00 00 00 00 00 00 00 00 00 00 00 00 00 00 00 00 00 12 13 15 15 15 15 15 15 15 15 15 15 15 15 15 15 10 26 27 00 00 00 00 00 00 00 00 00 00 24 25 13 15 15 15 15 15 10 22 22 11 00 00 00 00 24 25 13 15 15 15 15 15 15 15 15 10 26 27 00 00 00 00 00 
00 00 00 00 00 00 00 00 00 00 00 00 00 00 00 00 00 00 00 00 00 00 00 00 00 00 00 00 00 00 00 00 00 00 00 00 00 00 00 00 00 00 00 00 00 00 00 00 00 00 00 12 22 13 15 15 15 15 15 15 15 15 10 22 22 26 27 00 00 00 00 00 00 00 00 00 00 00 00 00 00 42 15 15 15 10 26 27 00 00 00 00 00 00 00 00 00 24 25 13 15 15 15 15 15 10 11 00 00 00 00 00 00 00 
00 00 00 00 00 00 00 00 00 00 00 00 00 00 00 00 00 00 00 00 00 00 00 00 00 00 00 00 00 00 00 00 00 00 00 00 00 00 00 00 00 00 00 00 00 00 00 00 00 00 00 00 00 24 30 30 30 30 30 30 30 30 27 00 00 00 00 00 00 00 00 00 00 00 00 00 00 00 00 00 00 49 22 22 26 27 00 00 00 00 00 00 00 00 00 00 00 00 00 24 25 22 22 26 30 27 00 00 00 00 00 00 00 00 
00 00 00 00 00 00 00 00 00 00 00 00 00 00 00 00 00 00 00 00 00 00 00 00 00 00 00 00 00 00 00 00 00 00 00 00 00 00 00 00 00 00 00 00 00 00 00 00 00 00 00 00 00 00 00 00 00 00 00 00 00 00 00 00 00 00 00 00 00 00 00 00 00 00 00 00 00 00 00 00 00 00 00 00 00 00 00 00 00 00 00 00 00 00 00 00 00 00 00 00 00 00 00 00 00 00 00 00 00 00 00 00 00 00 

OBJECT_LAYER
distance
DEC_stars2 642 376
DEC_stars2 770 664
DEC_stars2 288 576
/distance

OBJECT_LAYER
background
DEC_horizontal_portal 1886 623
DEC_horizontal_portal 1727 1760
DEC_vertical_portal 2156 863
DEC_vertical_portal 878 1727
DEC_vertical_portal 1209 1088
DEC_vertical_portal 2319 1887
DEC_vertical_portal 2285 351
DEC_vertical_portal 3409 831
DEC_horizontal_portal 798 1217
DEC_horizontal_portal 1885 1073
DEC_horizontal_portal 2638 1249
DEC_horizontal_portal 2783 799
/background

OBJECT_LAYER
foreground
DEC_Exit 3552 832
DEC_Exit 3552 864
DEC_Exit 3552 897
/foreground

ENEMIES
alien
point=503,846
point=960,646
point=604,1016
point=1010,805

alien
point=962,1068
point=500,856
point=648,663
point=1036,872
point=960,1070

alien
point=856,711
point=844,1059
point=730,915
point=613,979
point=577,844
point=657,722
point=856,714

alien
point=780,1061
point=659,1122
point=477,1029
point=445,876
point=897,622
point=1029,712
point=1022,940
point=948,1028
point=783,1064

alien
point=798,869
point=579,847
point=555,1092
point=853,1033
point=1043,1036
point=987,869
point=884,817
point=801,867

alien
point=591,591
point=407,703
point=533,855
point=763,924
point=860,808
point=879,576
point=592,592

alien
point=1978,1353
point=2165,1548
point=2481,1657

alien
point=2773,1645
point=2579,1764
point=2750,1911
point=2949,1779
point=2778,1647

/ENEMIES

CATCHERS
CATCHER_blue 791 205
CATCHER_blue 611 305
CATCHER_blue 530 496
CATCHER_blue 502 730
CATCHER_blue 749 627
CATCHER_blue 706 812
CATCHER_blue 496 942
CATCHER_blue 668 1027
CATCHER_blue 943 734
CATCHER_blue 920 906
CATCHER_blue 499 1540
CATCHER_blue 630 1652
CATCHER_blue 791 1768
CATCHER_blue 1065 1801
CATCHER_blue 1303 1873
CATCHER_blue 1503 1944
CATCHER_blue 1776 1945
CATCHER_blue 1686 1681
CATCHER_blue 1173 1091
CATCHER_blue 1433 1296
CATCHER_blue 1288 1453
CATCHER_blue 1044 1493
CATCHER_blue 848 1371
CATCHER_blue 832 1120
CATCHER_blue 1925 474
CATCHER_blue 2156 398
CATCHER_blue 1791 350
CATCHER_blue 1576 416
CATCHER_blue 1253 331
CATCHER_blue 1316 542
CATCHER_blue 1101 489
CATCHER_blue 2038 1969
CATCHER_blue 2460 390
CATCHER_blue 2537 530
CATCHER_blue 2688 627
CATCHER_blue 2816 732
CATCHER_blue 1926 794
CATCHER_blue 1924 972
CATCHER_blue 1768 877
CATCHER_blue 1580 870
CATCHER_blue 2084 906
CATCHER_blue 2326 990
CATCHER_blue 2844 1120
CATCHER_blue 2575 1019
CATCHER_blue 2816 942
CATCHER_blue 1914 1248
CATCHER_blue 2038 1438
CATCHER_blue 2313 1606
CATCHER_blue 2672 1479
CATCHER_blue 2594 1659
CATCHER_blue 2657 1822
CATCHER_blue 2464 1920
CATCHER_blue 2847 1716
CATCHER_blue 2866 1880
CATCHER_blue 3319 871
CATCHER_blue 3272 1244
CATCHER_blue 3273 1458
CATCHER_blue 3186 746
CATCHER_blue 3177 562
CATCHER_blue 3031 461
CATCHER_blue 3256 1077
/CATCHERS

ITEMS
ITEM_lightning 539 433
ITEM_banana 579 996
ITEM_banana 883 1006
ITEM_banana 748 1063
ITEM_banana 931 812
ITEM_banana 835 675
ITEM_banana 619 657
ITEM_banana 490 823
ITEM_banana 268 1456
ITEM_banana 349 1374
ITEM_banana 463 1346
ITEM_banana 418 1425
ITEM_banana 357 1493
ITEM_banana 1435 844
ITEM_banana 1503 781
ITEM_banana 1507 885
ITEM_banana 3045 1905
ITEM_banana 3033 1810
ITEM_banana 3289 1528
ITEM_banana 3204 1471
ITEM_banana 2942 410
ITEM_lightning 814 767
ITEM_lightning 615 873
ITEM_banana 1550 1651
ITEM_banana 1628 1608
ITEM_banana 1632 1695
ITEM_banana 1676 1625
ITEM_banana 1589 1676
ITEM_banana 720 1720
ITEM_banana 932 1427
ITEM_banana 1165 1474
ITEM_banana 1350 1377
/ITEMS

TELEPORTERS
(830,1217) (2815,799) (64,0)
(2670,1249) (1917,1073) (64,0)
(1918,623) (1759,1760) (64,0)
(2188,863) (910,1727) (0,64)
(1241,1088) (2351,1887) (0,64)
(2317,351) (3441,831) (0,-64)
/TELEPORTERS
