THEME
ice

SIZE
39 42

START
320 100

PAR_TIME
40

PLAYER
penguin

NEXTMAP
kevin_end

TERRAIN
15 15 15 15 15 15 15 15 15 15 15 15 15 15 15 15 15 15 15 15 15 15 15 15 15 15 15 15 15 15 15 15 15 15 15 15 15 15 15 
10 22 22 22 22 22 22 22 22 22 22 22 22 22 22 22 13 15 10 22 22 22 22 22 22 22 22 22 22 22 22 22 22 22 13 15 15 15 15 
16 00 00 00 00 00 00 00 00 00 00 00 00 00 00 00 24 30 27 00 00 00 00 00 00 00 00 00 00 00 00 00 00 00 12 13 15 15 15 
16 00 00 00 00 00 00 00 00 00 00 00 00 00 00 00 00 00 00 00 00 00 00 00 00 00 00 00 00 00 00 00 00 00 00 42 15 15 15 
16 00 00 00 00 00 00 00 00 00 00 00 00 00 00 00 00 00 00 00 00 00 00 00 00 00 00 00 00 00 00 00 00 00 00 49 13 15 15 
16 00 00 00 00 00 00 00 00 00 00 00 03 33 06 00 00 00 00 00 00 00 00 00 00 03 04 08 05 06 00 00 00 00 00 00 14 15 15 
16 00 00 00 00 07 08 08 08 08 08 08 20 15 17 08 08 08 08 08 08 08 08 08 08 41 26 30 25 34 08 18 00 00 00 00 14 15 15 
16 00 00 00 00 14 15 15 15 15 15 15 15 15 15 15 15 15 15 15 15 15 15 15 15 17 05 33 04 20 15 16 00 00 00 00 14 15 15 
16 00 00 00 00 14 15 15 15 15 15 15 15 15 15 15 15 15 15 15 15 15 15 15 15 15 15 15 15 15 15 16 00 00 00 00 14 15 15 
23 00 00 00 00 14 15 10 22 22 26 30 30 25 22 22 13 10 26 30 30 30 30 25 22 22 13 15 10 22 22 11 00 00 00 00 14 15 15 
00 00 00 00 00 14 15 16 00 00 00 00 00 00 00 00 21 23 00 00 00 00 00 00 00 00 21 22 11 00 00 00 00 00 00 00 14 15 15 
00 00 00 00 00 14 15 43 00 00 00 00 00 00 00 00 00 00 00 00 00 00 00 00 00 00 00 00 00 00 00 00 00 00 00 19 20 15 15 
00 00 00 00 00 14 10 50 00 00 00 00 00 00 00 00 00 00 00 00 00 00 00 00 00 00 00 00 00 00 00 00 00 03 04 20 15 15 15 
00 00 00 00 19 41 11 00 00 00 00 00 00 00 00 00 00 00 00 00 00 07 09 00 00 00 00 00 00 00 00 03 04 20 15 15 15 15 15 
08 08 08 08 20 43 00 00 00 00 03 33 33 33 33 33 04 08 08 08 08 20 17 05 33 33 33 04 08 08 08 20 15 15 15 15 15 15 15 
15 15 15 15 10 50 00 00 00 28 20 15 15 15 15 15 15 15 15 15 15 15 15 15 15 15 15 15 15 15 15 15 15 15 15 15 15 15 15 
15 15 15 15 43 00 00 00 00 35 15 15 15 15 15 15 15 15 15 15 15 15 15 15 15 15 15 15 15 15 15 15 15 15 15 15 15 15 15 
15 15 15 10 50 00 00 00 28 20 15 15 10 30 13 10 22 13 15 15 15 15 15 15 15 15 15 15 15 15 15 15 15 15 15 15 15 15 15 
15 15 15 43 00 00 00 00 35 15 15 15 16 00 14 16 00 14 15 15 15 15 15 15 15 15 15 15 15 15 15 15 15 15 15 15 15 15 15 
15 15 15 32 00 00 00 00 21 22 22 22 23 00 21 23 00 21 22 22 22 22 13 15 15 10 22 22 22 22 22 22 22 13 15 15 15 15 15 
15 15 15 32 00 00 00 00 00 00 00 00 00 00 00 00 00 00 00 00 00 00 21 22 26 27 00 00 00 00 00 00 00 12 13 15 15 15 15 
15 15 15 36 00 00 00 00 00 00 00 00 00 00 00 00 00 00 00 00 00 00 00 00 00 00 00 00 00 00 00 00 00 00 12 13 15 15 15 
15 15 15 17 18 00 00 00 00 00 00 00 00 00 00 00 00 00 00 00 00 00 00 00 00 00 00 00 00 00 00 00 00 00 00 14 15 15 15 
15 15 15 15 17 05 06 00 00 00 00 00 00 00 00 00 00 00 00 00 00 00 00 00 00 00 00 00 00 00 00 00 00 00 00 14 15 15 15 
15 15 15 15 15 15 17 08 08 08 08 08 08 09 00 07 09 00 07 08 08 18 00 00 00 00 00 00 00 00 00 00 00 00 00 21 13 15 15 
15 15 15 15 15 15 15 15 15 15 15 15 15 16 00 14 16 00 14 15 15 17 08 08 08 08 08 08 08 08 09 00 00 00 00 00 14 15 15 
15 15 15 15 15 15 15 15 15 15 15 15 15 17 33 20 17 08 20 15 15 15 15 15 15 15 15 10 22 22 23 00 00 00 00 07 20 15 15 
15 15 15 15 15 10 22 22 13 15 15 15 15 15 15 15 15 15 15 15 15 15 15 15 15 15 15 16 00 00 00 00 00 00 00 21 22 13 15 
15 15 15 15 10 11 00 00 12 13 15 15 15 15 15 15 15 15 15 15 15 15 15 15 15 15 15 17 08 08 09 00 00 00 00 00 00 14 15 
15 15 15 10 11 00 00 00 00 12 13 15 15 15 15 15 15 15 15 15 15 15 15 15 15 15 15 15 15 15 16 00 00 00 00 07 08 20 15 
15 15 10 11 00 00 00 00 00 00 12 22 22 22 22 22 13 15 15 15 15 15 15 15 15 15 10 22 22 22 23 00 00 00 00 14 15 15 15 
15 10 11 00 00 00 00 00 00 00 00 00 00 00 00 00 24 25 22 13 15 15 15 15 15 15 16 00 00 00 00 00 00 00 00 21 22 22 13 
10 11 00 00 00 00 19 18 00 00 00 00 00 00 00 00 00 00 00 24 30 25 13 15 15 15 17 08 08 08 09 00 00 00 00 00 00 00 14 
16 00 00 00 00 19 20 17 18 00 00 00 00 00 00 00 00 00 00 00 00 00 24 30 25 13 15 15 15 10 23 00 00 00 00 07 08 08 20 
16 00 00 00 19 20 15 15 17 08 08 08 08 08 05 06 00 00 00 00 00 00 00 00 00 12 13 15 15 16 00 00 00 00 00 14 15 15 15 
16 00 00 28 20 15 15 15 15 15 15 15 15 15 15 17 08 05 33 06 00 00 00 00 00 00 24 25 13 17 09 00 00 00 00 14 15 15 15 
16 00 00 49 13 15 15 15 15 15 15 15 15 15 15 15 15 15 15 17 05 33 06 00 00 00 00 00 12 22 23 00 00 00 00 14 15 15 15 
16 00 00 00 12 13 15 15 15 15 15 15 15 15 15 15 15 15 15 15 15 15 17 05 06 00 00 00 00 00 00 00 00 00 00 14 15 15 15 
16 00 00 00 00 14 15 15 15 15 15 15 15 15 15 15 15 15 15 15 15 15 15 15 17 18 00 00 00 00 00 00 00 00 19 20 15 15 15 
16 00 00 00 00 14 15 15 15 15 15 15 15 15 15 15 15 15 15 15 15 15 15 15 15 17 18 00 00 00 00 00 00 19 20 15 15 15 15 
16 00 00 00 00 14 15 15 15 15 15 15 15 15 15 15 15 15 15 15 15 15 15 15 15 15 17 05 06 00 00 03 04 20 15 15 15 15 15 
17 52 52 52 52 20 15 15 15 15 15 15 15 15 15 15 15 15 15 15 15 15 15 15 15 15 15 15 17 08 08 20 15 15 15 15 15 15 15 

OBJECT_LAYER
distance
/distance

OBJECT_LAYER
background
/background

OBJECT_LAYER
foreground
DEC_Exit 32 1312
DEC_Exit 64 1312
DEC_Exit 96 1312
DEC_Exit 128 1312
/foreground

ENEMIES
ice_spikes_180
point=560,92

ice_spikes_180
point=769,78

ice_spikes_90
point=1039,253

ice_spikes_180
point=723,317

ice_spikes_180
point=366,318

ice_spikes_180
point=402,318

ice_spikes_180
point=879,367

ice_spikes_180
point=847,367

ice_spikes
point=719,401

ice_spikes
point=687,401

ice_spikes
point=847,449

ice_spikes_180
point=559,367

ice_spikes_180
point=527,367

ice_spikes
point=418,451

ice_spikes
point=393,451

ice_spikes
point=365,449

ice_spikes
point=430,162

ice_spikes
point=670,177

ice_spikes
point=881,145

ice_spikes_180
point=1069,78

aars
point=55,385
point=103,370
point=103,132
point=1035,132
point=1091,150
point=1089,335
point=1011,373
point=919,408
point=300,408
point=235,516
point=190,632
point=246,713
point=774,713
point=1053,751
point=1053,1224
point=944,1249
point=851,1191
point=710,1119
point=558,1069
point=390,1046
point=315,1039
point=227,952
point=91,1061

ice_spikes_180
point=671,74

ice_spikes_90
point=126,624

ice_spikes_90
point=127,655

ice_spikes_180
point=376,653

ice_spikes
point=375,754

ice_spikes
point=511,753

ice_spikes_180
point=569,653

ice_bird2
point=431,637
point=431,729
point=431,589
point=431,636

ice_bird2
point=463,788
point=463,817
point=463,677
point=463,787

ice_bird2
point=527,645
point=527,605
point=527,745
point=527,646

ice_bird2
point=559,773
point=559,665
point=559,805
point=559,774

ice_spikes_180
point=752,686

ice_bird
point=1135,816
point=1024,816

ice_bird
point=911,879
point=1109,879

ice_bird
point=1167,911
point=1010,911

ice_bird
point=879,1007
point=1098,1007

ice_bird
point=1199,1041
point=1019,1041

ice_bird
point=976,1103
point=1100,1103

ice_spikes
point=688,1153

ice_spikes
point=592,1122

ice_spikes_180
point=499,1005

ice_spikes_180
point=960,1197

ice_spikes_180
point=205,909

ice_spikes_180
point=242,909

ice_spikes
point=832,786

ice_spikes
point=857,785

ice_spikes_180
point=847,655

ice_spikes_180
point=975,654

/ENEMIES

CATCHERS
CATCHER_blue 321 128
CATCHER_blue 544 128
CATCHER_blue 761 128
CATCHER_blue 974 128
CATCHER_blue 1039 343
CATCHER_blue 281 411
CATCHER_blue 173 587
CATCHER_blue 919 399
CATCHER_blue 772 400
CATCHER_blue 774 348
CATCHER_blue 619 346
CATCHER_blue 619 392
CATCHER_blue 475 406
CATCHER_blue 301 705
CATCHER_blue 640 702
CATCHER_blue 1044 731
CATCHER_blue 1045 951
CATCHER_blue 1043 1137
CATCHER_blue 921 1240
CATCHER_blue 775 1140
CATCHER_blue 522 1075
CATCHER_blue 379 1032
CATCHER_blue 297 1022
CATCHER_blue 214 968
CATCHER_blue 128 1038
CATCHER_blue 754 748
/CATCHERS

ITEMS
ITEM_krill 425 112
ITEM_krill 663 123
ITEM_krill 868 87
ITEM_krill 289 350
ITEM_krill 694 349
ITEM_krill 849 397
ITEM_lightning 245 695
ITEM_fish 467 685
ITEM_fish 812 704
ITEM_fish 1039 883
ITEM_fish 1041 1037
ITEM_fish 633 1076
ITEM_fish 100 1262
/ITEMS
