THEME
ice

SIZE
37 33

START
324 240

PAR_TIME
9

PLAYER
penguin

NEXTMAP
asteroid

TERRAIN
15 15 15 15 15 15 15 15 15 15 15 15 15 15 15 15 15 15 15 15 15 15 15 15 15 15 15 15 15 15 15 15 15 15 15 15 15 
15 15 15 15 15 15 15 15 10 22 22 13 15 15 15 15 15 15 15 15 15 15 15 15 15 15 15 15 15 15 15 15 15 15 15 15 15 
15 15 10 13 15 15 15 15 43 00 00 24 25 13 15 15 15 15 15 15 10 22 13 15 15 15 15 15 15 15 15 15 15 15 15 15 15 
15 15 43 12 13 15 15 10 50 00 00 00 00 24 25 22 22 22 22 26 27 00 12 22 22 22 22 22 22 22 22 22 22 22 22 13 15 
15 10 50 00 12 13 10 11 00 00 00 00 00 00 00 00 00 00 00 00 00 00 00 00 00 00 00 00 00 00 00 00 00 00 00 14 15 
15 16 00 00 00 24 27 00 00 00 00 00 00 00 00 00 00 00 00 00 00 00 00 00 00 00 00 00 00 00 00 00 00 00 00 14 15 
15 16 00 00 00 00 00 00 00 00 00 00 00 00 00 00 00 00 00 00 00 00 00 00 00 00 00 00 00 00 00 00 00 00 00 14 15 
15 16 00 00 00 00 00 00 00 00 00 00 00 00 00 00 00 00 00 00 00 00 00 00 00 00 00 00 00 00 00 00 00 00 00 14 15 
15 16 00 00 00 00 00 00 00 00 00 00 00 00 00 00 00 00 00 00 00 00 00 00 00 00 00 00 00 00 00 00 00 00 00 14 15 
15 16 00 00 00 00 00 00 00 00 00 00 00 00 00 00 00 00 00 00 00 00 00 00 00 00 00 00 00 00 00 00 00 00 00 14 15 
15 16 00 00 00 00 00 03 04 08 08 08 18 00 00 00 00 00 00 00 00 00 00 00 00 00 00 00 00 00 00 00 00 00 00 14 15 
15 16 00 00 00 00 28 20 15 15 15 15 17 08 18 00 00 00 00 00 00 00 00 00 00 00 00 00 00 00 00 00 00 00 00 14 15 
15 16 00 00 00 00 31 15 15 15 15 15 15 15 16 00 00 00 00 00 00 00 07 08 08 08 08 09 00 00 00 00 00 00 00 14 15 
15 16 00 00 00 00 49 22 22 22 22 22 22 26 27 00 00 00 00 00 00 00 14 15 15 15 15 16 00 00 00 00 00 00 00 14 15 
15 16 00 00 00 00 00 00 00 00 00 00 00 00 00 00 00 00 00 00 00 00 21 22 22 22 22 23 00 00 00 00 00 00 00 14 15 
15 17 29 00 00 00 00 00 00 00 00 00 00 00 00 00 00 00 00 00 00 00 00 00 00 00 00 00 00 00 00 00 00 00 00 14 15 
15 15 36 00 00 00 00 00 00 00 00 00 00 00 00 00 00 00 00 00 00 00 00 00 00 00 00 00 00 00 00 00 00 00 00 14 15 
15 15 17 05 06 00 00 00 00 00 00 00 00 00 00 00 00 00 00 00 00 00 00 00 00 00 00 00 00 00 00 00 00 00 00 14 15 
15 15 15 15 17 08 08 08 05 06 00 00 00 00 00 00 00 00 00 00 00 00 00 00 00 00 00 00 00 00 00 00 00 00 00 14 15 
15 15 15 15 15 15 15 15 15 16 00 00 00 00 00 00 00 00 00 00 00 00 00 00 00 00 00 00 00 00 00 00 00 00 19 20 15 
15 15 15 15 15 15 15 15 10 11 00 00 00 00 00 00 00 00 00 00 00 00 00 00 00 00 00 00 00 00 00 00 00 19 20 15 15 
15 15 15 15 15 15 10 26 27 00 00 00 00 00 00 00 07 08 08 08 08 08 09 00 00 00 00 00 00 00 03 04 08 20 15 15 15 
15 15 15 15 10 26 27 00 00 00 00 00 00 00 00 00 12 22 22 22 22 22 11 00 00 00 00 00 00 19 20 15 15 15 15 15 15 
15 15 15 10 11 00 00 00 00 00 00 00 00 00 00 00 00 00 00 00 00 00 00 00 00 00 00 00 00 14 15 15 15 15 15 15 15 
15 15 10 11 00 00 00 00 00 00 00 00 00 00 00 00 00 00 00 00 00 00 00 00 00 00 00 00 00 14 15 15 15 15 15 15 15 
15 15 43 00 00 00 00 00 00 00 00 00 00 00 00 00 00 00 00 00 00 00 00 00 00 00 00 00 00 24 30 30 25 22 22 22 13 
15 10 50 00 00 00 00 00 00 00 00 00 00 00 00 00 00 00 00 00 00 00 00 00 00 00 00 00 00 00 00 00 00 00 00 00 52 
15 16 00 00 00 00 00 00 00 00 00 00 00 00 00 00 00 00 00 00 00 00 00 00 00 00 00 00 00 00 00 00 00 00 00 00 52 
15 16 00 00 00 00 00 00 00 00 00 00 00 00 00 00 00 00 00 00 00 00 00 00 00 00 00 00 00 00 00 00 00 00 00 00 52 
15 16 00 00 00 00 00 00 00 00 00 00 00 00 00 00 00 00 00 00 00 00 00 00 00 00 00 00 00 00 00 00 00 00 00 00 52 
15 17 05 33 33 33 33 33 33 33 06 00 00 00 03 33 33 06 00 00 00 00 00 00 00 00 00 00 00 00 00 00 00 00 00 00 52 
15 15 15 15 15 15 15 15 15 15 17 08 08 08 20 15 15 17 08 08 08 08 08 08 08 08 08 08 08 08 08 08 08 08 08 08 20 
15 15 15 15 15 15 15 15 15 15 15 15 15 15 15 15 15 15 15 15 15 15 15 15 15 15 15 15 15 15 15 15 15 15 15 15 15 

OBJECT_LAYER
distance
/distance

OBJECT_LAYER
background
/background

OBJECT_LAYER
foreground
DEC_Exit 1152 864
DEC_Exit 1152 896
DEC_Exit 1152 928
DEC_Exit 1152 960
DEC_Exit 1152 827
/foreground

ENEMIES
ice_spikes_90
point=77,904

ice_bird
point=634,474
point=634,178

ice_bird
point=802,497
point=802,852

ice_bird
point=263,760
point=617,864
point=905,835

/ENEMIES

CATCHERS
CATCHER_blue 324 256
/CATCHERS

ITEMS
ITEM_krill 345 907
ITEM_krill 444 903
ITEM_krill 830 840
ITEM_fish 586 615
ITEM_lollipop 451 802
/ITEMS
