THEME
ice

SIZE
37 41

START
100 100

PLAYER
penguin

NEXTMAP
start

TERRAIN
10 22 22 22 22 22 22 22 22 22 22 22 22 22 22 22 22 22 22 22 22 22 22 22 22 22 22 22 22 22 22 22 22 22 22 22 13 
16 00 00 00 00 00 02 00 00 00 00 00 00 00 00 00 00 00 00 00 00 00 00 00 00 00 00 00 00 00 00 00 00 00 00 52 14 
16 00 00 00 00 00 02 00 00 00 00 00 00 00 00 00 00 00 00 00 00 00 00 00 00 00 00 00 00 00 00 00 00 00 00 52 14 
16 00 00 00 00 00 02 00 00 00 00 00 00 00 00 00 00 00 00 00 00 00 00 00 00 00 00 00 00 00 00 00 00 00 00 52 14 
16 00 00 00 00 00 02 00 00 00 00 00 00 00 00 00 00 00 00 00 00 00 00 00 00 00 00 00 00 00 00 00 00 00 00 52 14 
16 00 00 00 00 00 02 00 00 00 00 00 00 00 00 00 00 00 00 00 00 00 00 00 00 00 00 00 00 00 00 02 02 02 02 02 14 
16 00 00 00 00 00 02 00 00 00 00 00 00 00 00 00 00 00 00 00 00 00 00 00 00 00 00 00 00 00 00 00 00 00 00 00 14 
16 00 00 00 00 00 02 00 00 00 00 00 00 00 00 00 00 00 00 00 00 00 00 00 00 00 00 00 00 00 00 00 00 00 00 00 14 
16 00 00 00 00 00 02 00 00 00 00 00 00 00 00 00 00 00 00 00 00 00 00 00 00 00 00 00 00 00 00 00 00 00 00 00 14 
16 00 00 00 00 00 02 00 00 00 00 00 00 00 00 00 00 00 00 00 00 00 00 00 00 00 00 00 00 00 00 00 00 00 00 00 14 
16 00 00 00 00 00 02 00 00 00 00 00 00 00 00 00 00 00 00 00 00 00 00 00 00 00 00 00 00 00 00 00 00 00 00 00 14 
16 00 00 00 00 00 02 00 00 00 00 00 00 00 00 00 00 00 00 00 00 00 00 00 00 00 00 00 00 00 00 00 00 00 00 00 14 
16 00 00 00 00 00 02 00 00 00 00 00 00 00 00 00 00 00 00 00 00 00 00 00 00 00 00 00 00 00 00 00 00 00 00 00 14 
16 00 00 00 00 00 02 00 00 00 00 00 00 00 00 00 00 00 00 00 00 00 00 00 00 00 00 00 00 00 00 00 00 00 00 00 14 
16 00 00 00 00 00 02 00 00 00 00 00 00 00 00 00 00 00 00 00 00 00 00 00 00 00 00 00 00 00 00 00 00 00 00 00 14 
16 00 00 00 00 00 02 00 00 00 00 00 00 00 00 00 00 00 00 00 00 00 00 00 00 00 00 00 00 00 00 00 00 00 00 00 14 
16 00 00 00 00 00 02 00 00 00 00 00 00 00 00 00 00 00 00 00 00 00 00 00 00 00 00 00 00 00 00 00 00 00 00 00 14 
16 00 00 00 00 00 02 00 00 00 00 00 00 00 00 00 00 00 00 00 00 00 00 00 00 00 00 00 00 00 00 00 00 00 00 00 14 
16 00 00 00 00 00 02 00 00 00 00 00 00 00 00 00 00 00 00 00 00 00 00 00 00 00 00 00 00 00 00 00 00 00 00 00 14 
16 00 00 00 00 00 02 00 00 00 00 00 00 00 00 00 00 00 00 00 00 00 00 00 00 00 00 00 00 00 00 00 00 00 00 00 14 
16 00 00 00 00 00 02 00 00 00 00 00 00 00 00 00 00 00 00 00 00 00 00 00 00 00 00 00 00 00 00 00 00 00 00 00 14 
16 00 00 00 00 00 02 00 00 00 00 00 00 00 00 00 00 00 00 00 00 00 00 00 00 00 00 00 00 00 00 00 00 00 00 00 14 
16 00 00 00 00 00 02 00 00 00 00 00 00 00 00 00 00 00 00 00 00 00 00 00 00 00 00 00 00 00 00 00 00 00 00 00 14 
16 00 00 00 00 00 02 00 00 00 00 00 00 00 00 00 00 00 00 00 00 00 00 00 00 00 00 00 00 00 00 00 00 00 00 00 14 
16 00 00 00 00 00 02 00 00 00 00 00 00 00 00 00 00 00 00 00 00 00 00 00 00 00 00 00 00 00 00 00 00 00 00 00 14 
16 00 00 00 00 00 02 00 00 00 00 00 00 00 00 00 00 00 00 00 00 00 00 00 00 00 00 00 00 00 00 00 00 00 00 00 14 
16 00 00 00 00 00 02 00 00 00 00 00 00 00 00 00 00 00 00 00 00 00 00 00 00 00 00 00 00 00 00 00 00 00 00 00 14 
16 00 00 00 00 00 02 00 00 00 00 00 00 00 00 00 00 00 00 00 00 00 00 00 00 00 00 00 00 00 00 00 00 00 00 00 14 
16 00 00 00 00 00 02 00 00 00 00 00 00 00 00 00 00 00 00 00 00 00 00 00 00 00 00 00 00 00 00 00 00 00 00 00 14 
16 00 00 00 00 00 02 00 00 00 00 00 00 00 00 00 00 00 00 00 00 00 00 00 00 00 00 00 00 00 00 00 00 00 00 00 14 
16 00 00 00 00 00 02 00 00 00 00 00 00 00 00 00 00 00 00 00 00 00 00 00 00 00 00 00 00 00 00 00 00 00 00 00 14 
16 00 00 00 00 00 02 00 00 00 00 00 00 00 00 00 00 00 00 00 00 00 00 00 00 00 00 00 00 00 00 00 00 00 00 00 14 
16 00 00 00 00 00 02 00 00 00 00 00 00 00 00 00 00 00 00 00 00 00 00 00 00 00 00 00 00 00 00 00 00 00 00 00 14 
16 00 00 00 00 00 02 00 00 00 00 00 00 00 00 00 00 00 00 00 00 00 00 00 00 00 00 00 00 00 00 00 00 00 00 00 14 
16 00 00 00 00 00 02 00 00 00 00 00 00 00 00 00 00 00 00 00 00 00 00 00 00 00 00 00 00 00 00 00 00 00 00 00 14 
16 00 00 00 00 00 02 00 00 00 00 00 00 00 00 00 00 00 00 00 00 00 00 00 00 00 00 00 00 00 00 00 00 00 00 00 14 
16 00 00 00 00 00 00 00 00 00 00 00 00 00 00 00 00 00 00 00 00 00 00 00 00 00 00 00 00 00 00 00 00 00 00 00 14 
16 00 00 00 00 00 00 00 00 00 00 00 00 00 00 00 00 00 00 00 00 00 00 00 00 00 00 00 00 00 00 00 00 00 00 00 14 
16 00 00 00 00 00 00 00 00 00 00 00 00 00 00 00 00 00 00 00 00 00 00 00 00 00 00 00 00 00 00 00 00 00 00 00 14 
16 00 00 00 00 00 00 00 00 00 00 00 00 00 00 00 00 00 00 00 00 00 00 00 00 00 00 00 00 00 00 00 00 00 00 00 14 
17 08 08 08 08 08 08 08 08 08 08 08 08 08 08 08 08 08 08 08 08 08 08 08 08 08 08 08 08 08 08 08 08 08 08 08 20 

OBJECT_LAYER
background
/background

OBJECT_LAYER
foreground
DEC_Exit 1120 32
DEC_Exit 1120 64
DEC_Exit 1120 96
DEC_Exit 1120 128
/foreground

ENEMIES
aars
point=282,1114

aars
point=378,1114

aars
point=474,1114

aars
point=570,1114

aars
point=666,1114

aars
point=762,1117

aars
point=858,1117

aars
point=954,1117

aars
point=1050,1119

aars
point=1019,397
point=434,413

aars
point=430,401
point=428,744

aars
point=421,726
point=1037,738

aars
point=1051,739
point=1020,396

/ENEMIES

CATCHERS
CATCHER_blue 96 1203
CATCHER_blue 96 256
CATCHER_blue 288 1205
CATCHER_blue 288 1016
CATCHER_blue 512 768
CATCHER_blue 704 544
CATCHER_blue 896 288
CATCHER_blue 905 784
CATCHER_blue 512 288
CATCHER_blue 288 544
CATCHER_blue 1056 544
CATCHER_blue 704 896
CATCHER_blue 1056 896
/CATCHERS

ITEMS
ITEM_fish 160 576
ITEM_fish 160 640
ITEM_fish 160 704
ITEM_fish 160 960
ITEM_fish 160 768
ITEM_fish 160 832
ITEM_fish 160 896
ITEM_fish 32 608
ITEM_fish 32 672
ITEM_fish 32 736
ITEM_fish 32 800
ITEM_fish 32 864
ITEM_fish 32 928
ITEM_fish 32 992
ITEM_lollipop 197 1202
ITEM_lightning 193 1199
ITEM_fish 507 486
ITEM_fish 534 484
ITEM_fish 563 485
ITEM_fish 593 484
ITEM_fish 619 484
ITEM_fish 557 518
ITEM_fish 557 547
ITEM_fish 554 585
ITEM_fish 667 480
ITEM_fish 667 507
ITEM_fish 665 540
ITEM_fish 663 570
ITEM_fish 698 524
ITEM_fish 731 522
ITEM_fish 763 472
ITEM_fish 760 506
ITEM_fish 759 531
ITEM_fish 760 566
ITEM_fish 798 566
ITEM_fish 832 530
ITEM_fish 864 497
ITEM_fish 895 470
ITEM_fish 830 504
ITEM_fish 808 472
ITEM_fish 867 534
ITEM_fish 895 564
ITEM_fish 747 642
ITEM_fish 714 675
ITEM_fish 682 716
ITEM_fish 718 716
ITEM_fish 753 715
ITEM_fish 794 715
ITEM_fish 759 753
ITEM_fish 754 793
ITEM_fish 765 677
ITEM_fish 771 639
ITEM_fish 521 881
ITEM_fish 518 913
ITEM_fish 515 946
ITEM_fish 514 976
ITEM_fish 551 878
ITEM_fish 582 875
ITEM_fish 579 912
ITEM_fish 546 940
ITEM_fish 621 873
ITEM_fish 620 910
ITEM_fish 618 944
ITEM_fish 613 979
ITEM_fish 645 971
ITEM_fish 675 972
ITEM_fish 741 871
ITEM_fish 726 904
ITEM_fish 717 943
ITEM_fish 711 974
ITEM_fish 763 891
ITEM_fish 776 921
ITEM_fish 776 964
ITEM_fish 751 948
ITEM_fish 810 866
ITEM_fish 827 887
ITEM_fish 842 905
ITEM_fish 864 878
ITEM_fish 887 854
ITEM_fish 838 935
ITEM_fish 834 974
ITEM_fish 919 860
ITEM_fish 917 891
ITEM_fish 913 930
ITEM_fish 912 956
ITEM_fish 909 974
ITEM_fish 969 852
ITEM_fish 966 885
ITEM_fish 966 910
ITEM_fish 966 937
ITEM_fish 961 972
ITEM_fish 998 871
ITEM_fish 1013 897
ITEM_fish 1032 936
ITEM_fish 1051 956
ITEM_fish 1052 916
ITEM_fish 1053 883
ITEM_fish 1054 852
/ITEMS
