THEME
ice

SIZE
39 40

START
100 100

PLAYER
penguin

NEXTMAP
bossbattle

TERRAIN
10 22 22 22 22 22 22 22 22 22 22 22 22 22 22 22 22 22 22 22 22 22 22 22 22 22 22 22 22 22 22 22 22 22 22 22 22 22 13 
16 00 00 00 00 00 00 00 00 00 00 00 00 00 00 00 00 00 00 00 00 00 00 00 00 00 00 00 00 00 00 00 00 00 00 00 00 00 14 
16 00 00 00 00 00 00 00 00 00 00 00 00 00 00 00 00 00 00 00 00 00 00 00 00 00 00 00 00 00 00 00 00 00 00 00 00 00 14 
16 00 00 00 00 00 00 00 00 00 00 00 00 00 00 00 00 00 00 02 00 00 00 00 00 00 00 00 00 00 00 00 00 00 00 00 00 00 14 
16 00 00 00 00 00 00 00 00 00 00 00 00 00 00 00 00 00 00 02 00 00 00 00 00 00 00 00 00 00 00 00 00 00 00 00 00 00 14 
16 00 00 00 00 00 00 00 00 00 00 00 00 00 00 00 00 00 00 02 00 00 00 00 00 00 00 00 00 00 00 00 00 00 00 00 00 00 14 
16 00 00 00 00 00 00 00 00 00 00 00 00 00 00 00 00 00 00 02 00 00 00 00 00 00 00 00 00 00 00 00 00 00 00 00 00 00 14 
16 00 00 00 00 00 00 00 00 00 00 00 00 00 00 00 00 00 00 02 00 00 00 00 00 00 00 00 00 00 00 00 00 00 00 00 00 00 14 
16 00 00 00 00 00 00 00 00 00 00 00 00 00 00 00 00 00 00 02 00 00 00 00 00 00 00 00 00 00 00 00 00 00 00 00 00 00 14 
16 00 00 00 00 00 00 00 00 00 00 00 00 00 00 00 00 00 00 02 00 00 00 00 00 00 00 00 00 00 00 00 00 00 00 00 00 00 14 
16 00 00 00 00 00 00 00 00 00 00 00 00 00 00 00 00 00 00 02 00 00 00 00 00 00 00 00 00 00 00 00 00 00 00 00 00 00 14 
16 00 00 00 00 00 00 00 00 00 00 00 00 00 00 00 00 00 00 02 00 00 00 00 00 00 00 00 00 00 00 00 00 00 00 00 00 00 14 
16 00 00 00 00 00 00 00 00 00 00 00 00 00 00 00 00 00 00 02 00 00 00 00 00 00 00 00 00 00 00 00 00 00 00 00 00 00 14 
16 02 02 02 02 02 02 02 02 02 02 02 02 02 02 02 02 02 02 41 02 02 02 02 02 02 02 02 02 02 02 02 02 02 02 02 00 00 14 
16 00 00 00 00 00 00 00 00 00 00 00 00 00 00 00 00 00 00 02 00 00 00 00 00 00 00 00 00 00 00 00 00 00 00 00 00 00 14 
16 00 00 00 00 00 00 00 00 00 00 00 00 00 00 00 00 00 00 02 00 00 00 00 00 00 00 00 00 00 00 00 00 00 00 00 00 00 14 
16 00 00 00 00 00 00 00 00 00 00 00 00 00 00 00 00 00 00 02 00 00 00 00 00 00 00 00 00 00 00 00 00 00 00 00 00 00 14 
16 00 00 00 00 00 00 00 00 00 00 00 00 00 00 00 00 00 00 02 00 00 00 00 00 00 00 00 00 00 00 00 00 00 00 00 00 00 14 
16 00 00 00 00 00 00 00 00 00 00 00 00 00 00 00 00 00 00 02 00 00 00 00 00 00 00 00 00 00 00 00 00 00 00 00 00 00 14 
16 00 00 00 00 00 00 00 00 00 00 00 00 00 00 00 00 00 00 02 00 00 00 00 00 00 00 00 00 00 00 00 00 00 00 00 00 00 14 
16 00 00 00 00 00 00 00 00 00 00 00 00 00 00 00 00 00 00 02 00 00 00 00 00 00 00 00 00 00 00 00 00 00 00 00 00 00 14 
16 00 00 00 00 00 00 00 00 00 00 00 00 00 00 00 00 00 00 02 00 00 00 00 00 00 00 00 00 00 00 00 00 00 00 00 00 00 14 
16 00 00 00 00 00 00 00 00 00 00 00 00 00 00 00 00 00 00 02 00 00 00 00 00 00 00 00 00 00 00 00 00 00 00 00 00 00 14 
16 00 00 00 00 00 00 00 00 00 00 00 00 00 00 00 00 00 00 02 00 00 00 00 00 00 00 00 00 00 00 00 00 00 00 00 00 00 14 
16 00 00 00 00 00 00 00 00 00 00 00 00 00 00 00 00 00 00 00 00 00 00 00 00 00 00 00 00 00 00 00 00 00 00 00 00 00 14 
16 00 00 00 00 00 00 00 00 00 00 00 00 00 00 00 00 00 00 00 00 00 00 00 00 00 00 00 00 00 00 00 00 00 00 00 00 00 14 
16 00 00 02 02 02 02 02 02 02 02 02 02 02 02 02 02 02 02 02 02 02 02 02 02 02 02 02 02 02 02 02 02 02 02 02 02 02 14 
16 00 00 00 00 00 00 00 00 00 00 00 00 00 00 00 00 00 00 02 00 00 00 00 00 00 00 00 00 00 00 00 00 00 00 00 52 52 14 
16 00 00 00 00 00 00 00 00 00 00 00 00 00 00 00 00 00 00 02 00 00 00 00 00 00 00 00 00 00 00 00 00 00 00 00 52 52 14 
16 00 00 00 00 00 00 00 00 00 00 00 00 00 00 00 00 00 00 02 00 00 00 00 00 00 00 00 00 00 00 00 00 00 00 00 00 00 14 
16 00 00 00 00 00 00 00 00 00 00 00 00 00 00 00 00 00 00 02 00 00 00 00 00 00 00 00 00 00 00 00 00 00 00 00 00 00 14 
16 00 00 00 00 00 00 00 00 00 00 00 00 00 00 00 00 00 00 02 00 00 00 00 00 00 00 00 00 00 00 00 00 00 00 00 00 00 14 
16 00 00 00 00 00 00 00 00 00 00 00 00 00 00 00 00 00 00 02 00 00 00 00 00 00 00 00 00 00 00 00 00 00 00 00 00 00 14 
16 00 00 00 00 00 00 00 00 00 00 00 00 00 00 00 00 00 00 02 00 00 00 00 00 00 00 00 00 00 00 00 00 00 00 00 00 00 14 
16 00 00 00 00 00 00 00 00 00 00 00 00 00 00 00 00 00 00 02 00 00 00 00 00 00 00 00 00 00 00 00 00 00 00 00 00 00 14 
16 00 00 00 00 00 00 00 00 00 00 00 00 00 00 00 00 00 00 02 00 00 00 00 00 00 00 00 00 00 00 00 00 00 00 00 00 00 14 
16 00 00 00 00 00 00 00 00 00 00 00 00 00 00 00 00 00 00 02 00 00 00 00 00 00 00 00 00 00 00 00 00 00 00 00 00 00 14 
16 00 00 00 00 00 00 00 00 00 00 00 00 00 00 00 00 00 00 00 00 00 00 00 00 00 00 00 00 00 00 00 00 00 00 00 00 00 14 
16 00 00 00 00 00 00 00 00 00 00 00 00 00 00 00 00 00 00 00 00 00 00 00 00 00 00 00 00 00 00 00 00 00 00 00 00 00 14 
17 08 08 08 08 08 08 08 08 08 08 08 08 08 08 08 08 08 08 08 08 08 08 08 08 08 08 08 08 08 08 08 08 08 08 08 08 08 20 

OBJECT_LAYER
background
/background

OBJECT_LAYER
foreground
DEC_Exit 1184 864
DEC_Exit 1152 864
DEC_Exit 1152 896
DEC_Exit 1184 896
/foreground

ENEMIES
fish_normal
point=527,79
point=525,218

fish_normal
point=463,143
point=463,285

fish_normal
point=399,207
point=399,348

fish_normal
point=335,271
point=335,413

fish_fast
point=889,303
point=949,388
point=1100,385
point=1156,324
point=1110,251
point=950,248
point=894,307

fish_fast
point=892,114
point=961,60
point=1123,65
point=1163,124
point=1114,199
point=956,199
point=892,119

fish_fast
point=1160,216
point=673,216

fish_fast
point=943,623
point=1023,553
point=1100,632

fish_fast
point=911,623
point=847,558
point=907,482

fish_fast
point=911,655
point=842,730
point=764,657

fish_fast
point=943,655
point=1021,722
point=945,781

fish_fast
point=367,591
point=58,591
point=371,807

fish_fast
point=335,623
point=60,623
point=337,808

fish_fast
point=303,655
point=58,655
point=298,808

fish_fast
point=591,911
point=70,1160

fish_fast
point=591,975
point=70,1105

fish_fast
point=591,1039
point=72,1041

fish_fast
point=591,1103
point=72,976

fish_fast
point=591,1167
point=69,918

fish_normal
point=687,943
point=923,1155

fish_normal
point=688,944
point=859,1165

fish_normal
point=689,943
point=941,1093

fish_normal
point=689,944
point=949,944

/ENEMIES

CATCHERS
CATCHER_blue 120 319
CATCHER_blue 511 325
CATCHER_blue 613 66
CATCHER_blue 1157 419
CATCHER_blue 614 775
CATCHER_blue 65 837
CATCHER_blue 615 1192
CATCHER_blue 608 320
CATCHER_blue 919 630
CATCHER_blue 316 1030
CATCHER_blue 1172 1186
/CATCHERS

ITEMS
ITEM_lollipop 40 456
ITEM_carrot 1103 901
ITEM_carrot 1074 871
ITEM_carrot 1039 903
ITEM_carrot 1003 873
ITEM_carrot 970 903
ITEM_carrot 932 871
ITEM_carrot 898 903
ITEM_carrot 860 868
ITEM_carrot 828 904
ITEM_carrot 790 869
ITEM_carrot 761 903
ITEM_carrot 725 870
ITEM_carrot 698 906
ITEM_carrot 664 875
/ITEMS
