THEME
underground

SIZE
37 34

START
100 850

PLAYER
turtle

NEXTMAP
kevin2

TERRAIN
10 22 22 22 22 22 22 22 22 22 22 22 22 22 22 22 22 22 22 22 22 22 22 22 22 22 22 22 22 22 22 22 22 22 22 22 13 
16 00 00 00 00 00 00 00 00 00 00 00 00 00 00 00 00 00 00 00 00 00 00 00 00 00 00 00 00 00 00 00 00 00 00 00 14 
16 00 00 00 00 00 00 00 00 00 00 00 00 00 00 00 00 00 00 00 00 00 00 00 00 00 00 00 00 00 00 00 00 00 00 00 14 
16 00 00 00 00 00 00 00 00 00 00 00 00 00 00 00 00 00 00 00 00 00 00 00 00 00 00 00 00 00 00 00 00 00 00 00 14 
16 00 00 00 00 00 00 00 00 00 00 00 00 00 00 00 00 00 00 00 00 00 00 00 00 00 00 00 00 00 00 00 00 00 00 00 14 
16 00 00 00 00 00 00 00 00 00 00 00 00 00 00 00 00 00 00 00 00 00 00 00 00 00 00 00 00 00 00 00 00 00 00 00 14 
16 00 00 00 00 00 00 00 00 00 19 08 08 18 00 00 00 00 00 00 00 00 00 00 00 00 00 00 00 00 00 00 00 00 00 00 14 
16 00 00 00 00 00 00 00 00 00 14 15 15 17 05 06 00 00 00 00 00 00 00 00 00 00 00 00 00 00 00 00 00 00 00 00 14 
16 00 00 00 00 00 00 00 00 00 14 15 15 15 15 16 00 00 00 00 00 00 00 00 00 00 00 00 00 00 00 00 00 00 00 00 14 
16 00 00 00 00 00 00 00 00 00 14 15 15 15 15 16 00 00 00 00 00 00 00 00 00 00 00 00 00 00 00 00 00 00 00 00 14 
16 00 00 00 00 00 00 00 00 19 20 15 15 15 15 16 00 00 00 00 00 00 00 00 00 00 00 00 00 00 00 00 00 00 00 00 14 
16 00 52 52 52 52 52 00 19 20 15 15 15 15 15 43 00 00 00 00 00 00 00 00 00 00 00 00 00 00 00 00 00 00 00 00 14 
16 00 03 33 06 00 00 19 20 15 15 15 10 22 22 50 00 00 00 00 00 00 00 00 00 00 00 00 00 00 00 00 00 00 00 00 14 
17 08 20 15 17 08 08 20 15 15 15 10 11 00 00 00 00 00 00 00 00 00 00 00 00 00 00 00 00 00 00 00 00 00 00 00 14 
15 15 15 15 15 15 15 15 15 15 10 11 00 00 00 00 00 00 00 00 00 00 00 00 00 00 00 00 00 00 00 00 00 00 00 00 14 
15 15 15 15 15 15 15 15 15 15 43 00 00 00 00 00 00 00 00 00 00 00 00 00 00 00 00 00 00 00 00 00 00 00 00 00 14 
15 15 15 15 15 15 15 10 22 22 50 00 00 00 00 00 00 00 00 00 00 00 00 00 00 00 00 00 00 00 00 00 00 00 00 00 14 
15 15 10 22 22 22 26 27 00 00 00 00 00 00 00 00 00 00 00 00 00 00 00 00 00 00 00 00 00 00 00 00 00 00 00 00 14 
10 26 27 00 00 00 00 00 00 00 00 00 00 00 00 00 00 00 00 00 00 00 00 00 00 00 00 00 00 00 00 00 00 00 00 00 14 
16 00 00 00 00 00 00 00 00 00 00 00 00 00 00 00 00 00 00 00 00 00 00 00 00 00 00 00 00 00 00 00 00 00 00 00 14 
16 00 00 00 00 00 00 00 00 00 00 00 00 00 00 00 00 00 00 00 00 00 00 00 00 00 00 00 00 00 00 00 00 00 00 00 14 
16 00 00 00 00 00 00 00 00 00 00 00 00 00 19 08 08 18 00 00 00 00 00 00 00 00 00 00 00 00 00 00 00 00 00 00 14 
16 00 00 00 00 00 00 00 00 00 00 00 00 00 14 15 15 17 18 00 00 00 00 00 00 00 00 00 00 00 00 00 00 00 00 00 14 
16 00 00 00 00 00 00 00 00 00 00 00 00 28 20 15 15 15 16 00 00 00 00 00 00 00 00 00 00 00 00 00 00 00 00 00 14 
16 00 00 00 00 00 00 00 00 00 00 00 00 35 15 15 15 15 16 00 00 00 00 00 00 00 00 00 00 00 00 00 00 00 00 00 14 
16 00 00 00 00 00 00 00 00 00 00 00 19 20 15 15 15 15 16 00 00 00 00 00 00 00 00 00 00 00 00 00 00 00 00 00 14 
16 00 00 00 00 00 00 00 00 00 00 19 20 15 15 15 15 15 16 00 00 00 00 00 00 00 00 00 00 00 00 00 00 00 00 00 14 
16 00 00 00 00 00 00 00 00 00 19 20 15 15 15 15 15 15 16 00 00 00 00 00 00 00 00 00 00 00 00 00 00 00 00 00 14 
16 00 00 00 00 00 00 00 00 19 20 15 15 15 15 15 15 15 16 00 00 00 00 00 00 00 00 00 00 00 00 00 00 00 00 00 14 
16 00 00 00 00 00 00 00 19 20 15 15 15 15 15 15 15 10 11 00 00 00 00 00 00 00 00 00 00 00 00 00 00 00 00 00 14 
16 00 00 00 00 00 00 28 20 15 15 15 15 15 15 15 15 16 00 00 00 00 00 00 00 00 00 00 00 00 00 00 00 00 00 00 14 
16 00 00 00 00 00 00 35 15 15 15 15 15 15 15 10 22 11 00 00 00 00 00 00 00 00 00 00 00 00 00 00 00 00 00 00 14 
16 00 00 00 00 00 00 14 15 15 15 15 15 15 15 16 00 00 00 00 00 00 00 00 00 00 00 00 00 00 00 00 00 00 00 00 14 
17 08 08 08 08 08 08 20 15 15 15 15 15 15 15 17 08 08 08 08 08 08 08 08 08 08 08 08 08 08 08 08 08 08 08 08 20 

OBJECT_LAYER
distance
/distance

OBJECT_LAYER
background
/background

OBJECT_LAYER
foreground
DEC_Exit 199 352
DEC_Exit 170 352
DEC_Exit 139 352
DEC_Exit 108 352
DEC_Exit 78 350
DEC_Exit 49 352
/foreground

ENEMIES
bug_yellow
point=363,623
point=90,809
point=361,623

bug_blue
point=1007,783
point=1007,561
point=1007,784

bug_blue
point=943,559
point=784,559
point=1006,559

bug_blue
point=783,687
point=785,786
point=785,561

bug_blue
point=879,783
point=1010,783
point=785,783

bug_green
point=631,876
point=751,1047
point=628,878

bug_yellow
point=879,271
point=790,176
point=880,272

bug_yellow
point=879,271
point=984,170
point=881,273

bug_yellow
point=879,271
point=984,371
point=879,274

bug_yellow
point=879,271
point=779,370
point=878,274

bug_yellow
point=1122,232
point=59,242
point=1123,233

/ENEMIES

CATCHERS
CATCHER_blue 121 960
CATCHER_blue 132 672
CATCHER_blue 352 672
CATCHER_blue 518 512
CATCHER_blue 703 672
CATCHER_blue 864 864
CATCHER_blue 1056 672
CATCHER_blue 864 481
CATCHER_blue 1056 270
CATCHER_blue 704 272
CATCHER_blue 864 96
CATCHER_blue 512 96
CATCHER_blue 224 96
/CATCHERS

ITEMS
ITEM_lightning 582 1011
ITEM_carrot 244 674
ITEM_carrot 133 826
ITEM_carrot 441 587
ITEM_carrot 783 559
ITEM_carrot 998 554
ITEM_carrot 999 770
ITEM_carrot 780 770
ITEM_carrot 823 263
ITEM_carrot 919 262
ITEM_carrot 869 215
ITEM_carrot 870 312
ITEM_lollipop 527 278
ITEM_carrot 704 96
ITEM_carrot 1044 94
ITEM_carrot 368 95
ITEM_carrot 114 99
/ITEMS
