THEME
underground

SIZE
37 41

START
100 100

PLAYER
turtle

NEXTMAP
kevin5

TERRAIN
10 22 22 22 22 22 22 22 13 15 15 15 15 15 15 15 15 10 22 22 22 13 15 15 15 15 15 15 15 16 52 52 52 52 52 52 14 
16 00 00 00 00 00 00 00 12 13 15 15 15 15 15 10 22 50 00 00 00 21 13 15 15 15 15 15 10 27 52 52 52 52 52 52 14 
16 00 00 00 00 00 00 00 00 42 15 15 15 15 15 43 00 00 00 00 00 00 14 15 15 15 15 10 11 00 00 00 00 00 00 00 14 
16 00 00 00 00 00 00 00 00 49 13 15 15 15 10 50 00 00 00 00 00 00 12 13 15 15 15 16 00 00 00 00 00 00 00 00 14 
16 00 00 00 00 00 00 00 00 00 42 15 15 15 16 00 00 00 00 00 00 00 00 12 13 15 15 16 00 00 00 00 00 00 00 00 14 
16 00 00 00 00 00 00 00 00 00 49 13 15 15 16 00 00 00 00 00 00 00 00 00 42 15 15 16 00 00 00 00 00 00 00 00 14 
16 00 00 00 00 00 00 00 00 00 00 14 15 15 43 00 00 00 00 00 00 00 00 00 49 13 10 11 00 00 00 00 00 00 00 00 14 
16 00 00 00 00 00 00 00 00 00 00 14 15 10 50 00 00 00 00 00 00 00 00 00 00 14 16 00 00 00 00 00 00 00 00 00 14 
16 00 00 00 00 00 00 00 00 00 00 12 13 16 00 00 00 00 00 00 00 00 00 00 28 41 23 00 00 00 00 00 00 00 00 00 14 
16 00 00 00 00 00 00 00 00 00 00 28 20 16 00 00 00 00 00 00 00 00 00 00 35 16 00 00 00 00 00 00 00 00 00 00 14 
16 00 00 00 00 00 00 00 00 00 00 31 15 16 00 00 00 00 00 00 00 00 00 28 20 16 00 00 00 00 00 00 00 00 00 00 14 
16 00 00 00 00 00 00 00 00 00 00 49 13 16 00 00 00 00 00 00 00 00 00 35 10 23 00 00 00 00 00 00 00 00 00 00 14 
16 00 00 00 00 00 00 00 00 00 00 00 12 11 00 00 00 00 00 00 00 00 00 24 27 00 00 00 00 00 00 00 00 00 00 00 14 
16 00 00 00 00 00 00 00 00 00 00 00 00 00 00 00 00 00 00 00 00 00 00 00 00 00 00 00 00 00 00 00 00 00 00 00 14 
16 00 00 00 00 00 00 00 00 00 00 00 00 00 00 00 00 00 00 00 00 00 00 00 00 00 00 00 00 00 00 00 00 00 00 00 14 
16 00 00 00 00 00 00 00 00 00 00 00 00 00 00 00 00 00 00 00 00 00 00 00 00 00 00 00 00 00 00 00 00 00 00 00 14 
16 00 00 00 00 00 00 00 00 00 00 00 00 00 00 00 00 00 00 00 00 00 00 00 00 00 00 00 00 00 00 00 00 00 00 00 14 
16 00 00 00 00 00 00 00 00 00 00 00 00 19 08 08 08 18 00 00 00 00 00 00 00 00 00 00 00 00 00 00 00 00 00 00 14 
16 00 00 00 00 00 00 00 00 00 00 00 19 20 15 15 15 17 08 08 18 00 00 00 00 00 00 00 00 00 00 00 00 00 00 00 14 
16 00 00 00 00 00 00 00 00 00 00 19 20 15 15 15 15 15 15 15 16 00 00 00 00 00 00 00 00 00 00 00 00 00 00 00 14 
16 00 00 00 00 00 00 00 00 00 19 20 15 15 15 15 15 15 15 15 16 00 00 00 00 00 00 00 00 00 00 00 00 00 00 00 14 
16 00 00 00 00 00 00 00 00 00 14 15 15 15 15 15 15 15 15 10 11 00 00 00 00 00 00 00 00 00 00 00 00 00 00 00 14 
16 00 00 00 00 00 00 00 00 00 14 15 15 15 15 15 15 15 15 43 00 00 00 00 00 00 00 00 00 00 00 00 00 00 00 00 14 
16 00 00 00 00 00 00 00 00 00 14 10 26 30 25 13 15 15 10 50 00 00 00 00 00 00 00 00 00 00 00 00 00 00 00 00 14 
16 00 00 00 00 00 00 00 00 00 24 27 00 00 00 42 15 15 16 00 00 00 00 00 00 28 08 29 00 00 00 00 00 00 00 00 14 
16 00 00 00 00 00 00 00 00 00 00 00 00 00 00 35 15 15 17 18 00 00 00 00 00 31 10 50 00 00 00 00 00 00 00 00 14 
16 00 00 00 00 00 00 00 00 00 00 00 00 00 00 14 15 15 10 11 00 00 00 00 00 35 16 00 00 00 00 00 00 00 00 00 14 
16 00 00 00 00 00 00 00 00 00 00 00 00 00 00 12 22 26 27 00 00 00 00 00 28 20 16 00 00 00 00 00 00 00 00 00 14 
16 00 00 00 00 00 00 00 00 00 00 00 00 00 00 00 00 00 00 00 00 00 00 00 35 15 16 00 00 00 00 00 00 00 00 00 14 
16 00 00 00 00 00 00 00 00 00 00 00 00 00 00 00 00 00 00 00 00 00 00 28 20 15 16 00 00 00 00 00 00 00 00 00 14 
16 00 00 00 00 00 00 00 00 00 00 00 07 18 00 00 00 00 00 00 00 00 00 35 15 15 16 00 00 00 00 00 00 00 00 00 14 
16 00 00 00 00 00 00 00 00 00 00 00 14 16 00 00 00 00 00 00 00 00 00 14 15 15 16 00 00 00 00 00 00 00 00 00 14 
16 00 00 00 00 00 00 00 00 00 00 00 14 16 00 00 00 00 00 00 00 00 19 20 15 15 17 18 00 00 00 00 00 00 00 00 14 
16 00 00 00 00 00 00 00 00 00 00 00 14 16 00 00 00 00 00 00 00 28 20 15 15 15 15 17 09 00 00 00 00 00 00 00 14 
16 00 00 00 00 00 00 00 00 00 00 00 14 16 00 00 00 00 00 00 00 49 13 15 15 15 15 15 16 00 00 00 00 00 00 00 14 
16 00 00 00 00 00 00 00 00 00 00 19 41 23 00 00 00 00 00 00 00 28 20 15 15 15 15 15 16 00 00 00 00 00 00 00 14 
16 00 00 00 00 00 00 00 00 00 28 20 16 00 00 00 00 00 00 00 00 35 15 15 15 15 15 10 27 00 00 00 00 00 00 00 14 
16 00 00 00 00 00 00 00 00 00 35 15 16 00 00 00 00 00 00 00 28 20 15 15 15 15 15 16 00 00 00 00 00 00 00 00 14 
16 00 00 00 00 00 00 00 00 19 20 10 27 00 00 00 00 00 00 00 35 15 15 15 15 15 10 11 00 00 00 00 00 00 00 00 14 
16 00 00 00 00 00 00 00 00 14 15 16 00 00 00 00 00 00 00 19 20 15 15 15 15 15 17 18 00 00 00 00 00 00 00 00 14 
17 08 08 08 08 08 08 08 08 20 15 17 08 08 08 08 08 08 08 20 15 15 15 15 15 15 15 17 08 08 08 08 08 08 08 08 20 

OBJECT_LAYER
distance
/distance

OBJECT_LAYER
background
/background

OBJECT_LAYER
foreground
DEC_Exit 960 0
DEC_Exit 992 0
DEC_Exit 1024 0
DEC_Exit 1056 0
DEC_Exit 1088 0
DEC_Exit 1120 0
/foreground

ENEMIES
bug_blue
point=143,495
point=143,298

bug_green
point=495,271
point=740,271
point=495,271

bug_green
point=527,239
point=772,239
point=527,239

bug_green
point=495,207
point=740,207
point=496,208

bug_yellow
point=1071,239
point=1071,1210
point=1071,239

bug_yellow
point=1007,239
point=1007,1210
point=1007,239

bug_yellow
point=1039,239
point=1039,1210
point=1039,239

bug_yellow
point=1135,143
point=915,143
point=1133,144

bug_blue
point=975,559
point=849,559
point=971,445

bug_blue
point=943,591
point=732,591

bug_blue
point=975,655
point=853,655
point=966,770

bug_blue
point=943,623
point=731,623

bug_green
point=431,495
point=71,794
point=431,495

bug_blue
point=511,1008
point=682,981

/ENEMIES

CATCHERS
CATCHER_blue 128 182
CATCHER_blue 136 1130
CATCHER_blue 292 901
CATCHER_blue 554 1183
CATCHER_blue 730 801
CATCHER_blue 1103 1217
CATCHER_blue 946 943
CATCHER_blue 803 498
CATCHER_blue 601 308
CATCHER_blue 1000 288
/CATCHERS

ITEMS
ITEM_carrot 322 333
ITEM_carrot 332 390
ITEM_carrot 374 437
ITEM_carrot 421 440
ITEM_carrot 459 394
ITEM_carrot 474 322
ITEM_lollipop 612 45
ITEM_carrot 633 767
ITEM_lightning 398 1242
ITEM_carrot 410 785
ITEM_carrot 988 994
ITEM_carrot 1011 1038
ITEM_carrot 1030 1082
ITEM_carrot 1057 1132
ITEM_carrot 1080 1176
/ITEMS
