THEME
underwater

SIZE
37 41

START
100 100

PLAYER
pufferfish

NEXTMAP
kevin4

TERRAIN
10 22 22 22 22 22 22 22 22 22 22 22 22 22 22 22 22 22 22 22 13 15 15 15 15 15 15 15 15 15 15 15 15 15 10 22 13 
16 00 00 00 00 00 00 00 00 00 00 00 00 00 00 00 00 00 00 00 14 15 15 15 15 15 15 15 15 15 15 15 15 10 50 00 14 
16 00 00 00 00 00 00 00 00 00 00 00 00 00 00 00 00 00 00 00 12 22 22 13 15 15 15 15 15 15 15 15 10 11 00 00 14 
16 00 00 00 00 00 00 00 00 00 00 00 00 00 00 00 00 00 00 00 00 00 00 21 13 15 15 15 15 15 15 10 23 00 00 00 14 
16 00 00 00 00 00 00 00 00 00 00 00 00 00 00 00 00 00 00 00 00 00 00 00 24 13 15 15 15 15 15 16 00 00 00 00 14 
16 00 00 00 00 00 00 00 00 00 00 00 00 00 00 00 00 00 00 00 00 00 00 00 00 14 15 15 15 15 15 16 00 00 00 00 14 
17 08 18 00 00 00 00 00 00 00 00 00 00 00 00 00 00 00 00 00 00 00 00 00 00 14 15 15 15 15 15 43 00 00 00 00 14 
15 15 17 09 00 00 03 33 33 33 33 33 06 00 00 00 00 00 00 00 00 00 00 00 00 14 15 15 15 15 10 50 00 00 00 00 14 
15 15 15 17 08 08 20 15 15 15 15 15 17 08 09 00 00 00 00 00 00 00 00 00 00 14 15 15 15 15 16 00 00 00 00 00 14 
15 15 15 15 15 15 15 15 15 15 15 15 15 15 16 00 00 00 00 00 00 00 00 00 07 20 15 15 15 15 17 29 00 00 00 00 14 
15 15 15 15 10 22 22 13 15 15 15 15 15 15 16 00 00 00 00 00 00 00 00 00 14 15 15 15 15 15 15 32 00 00 00 00 14 
15 10 22 22 11 00 00 12 22 13 15 15 15 15 16 00 00 00 00 00 00 00 00 00 14 15 15 15 15 15 15 32 00 00 00 00 14 
10 11 00 00 00 00 00 00 00 21 22 22 22 22 11 00 00 00 00 00 00 00 00 00 12 22 22 22 22 22 22 50 00 00 00 00 14 
16 00 00 00 00 00 00 00 00 00 00 00 00 00 00 00 00 00 00 00 00 00 00 00 00 00 00 00 00 00 00 00 00 00 00 00 14 
16 00 00 00 00 00 00 00 00 00 00 00 00 00 00 00 00 00 00 00 00 00 00 00 00 00 00 00 00 00 00 00 00 00 00 00 14 
16 00 00 00 00 00 00 00 00 00 00 00 00 00 00 00 00 00 00 00 00 00 00 00 00 00 00 00 00 00 00 00 00 00 00 00 14 
16 00 00 00 00 00 00 00 00 00 00 00 00 00 00 00 00 00 00 19 36 00 00 00 00 00 00 00 00 00 00 00 00 00 00 00 14 
16 00 00 00 00 00 00 00 00 00 00 00 00 00 00 00 00 03 04 20 16 00 00 00 00 00 00 00 00 00 00 00 00 00 00 00 14 
16 00 00 00 00 00 00 00 00 00 00 00 00 00 00 00 00 14 15 15 16 00 00 00 00 00 00 00 00 00 00 00 00 00 00 00 14 
16 00 00 00 00 00 00 00 00 03 06 00 00 00 00 00 00 21 22 22 23 00 00 00 00 00 00 28 08 18 00 00 00 00 00 00 14 
16 00 00 00 00 00 00 00 19 20 17 18 00 00 00 00 00 00 00 00 00 00 00 00 00 00 00 35 15 16 00 00 00 00 00 00 14 
16 00 00 00 00 00 28 08 20 15 10 11 00 00 00 00 00 00 00 00 00 00 00 00 00 00 00 14 10 23 00 00 00 00 00 00 14 
16 00 00 00 00 00 31 15 15 15 16 00 00 00 00 00 00 00 00 00 00 00 00 00 00 00 00 24 27 00 00 00 00 00 00 00 14 
16 00 00 00 00 00 31 22 13 15 17 29 00 00 00 00 00 00 00 00 00 00 00 00 00 00 00 00 00 00 00 00 00 00 00 00 14 
16 00 00 00 00 00 00 00 12 22 22 50 00 00 00 00 00 00 00 00 00 00 00 00 00 00 00 00 00 00 00 00 00 00 00 00 14 
16 00 00 00 00 00 00 00 00 00 00 00 00 00 00 00 07 08 08 18 00 00 00 00 00 00 00 00 00 00 00 00 00 00 00 00 14 
16 00 00 00 00 00 00 00 00 00 00 00 00 00 00 00 14 15 15 16 00 00 00 00 00 00 00 00 00 00 00 00 00 00 00 00 14 
16 00 00 00 00 00 00 00 00 00 00 00 00 00 00 00 12 13 15 17 18 00 00 00 00 00 00 00 00 00 00 00 19 18 00 00 14 
16 00 00 00 00 00 00 00 00 00 00 00 00 00 00 00 00 12 22 22 23 00 00 00 00 00 00 00 00 07 08 08 41 23 00 00 14 
17 18 00 03 33 06 00 00 00 00 00 00 00 00 00 00 00 00 00 00 00 00 00 00 00 00 00 00 00 42 15 15 16 00 00 00 14 
15 17 08 20 15 17 18 00 00 00 00 00 00 00 00 00 00 00 00 00 00 00 00 00 00 00 00 00 00 49 13 10 11 00 00 00 14 
15 15 10 22 22 13 17 08 09 00 00 00 00 00 00 00 00 00 00 00 00 00 00 00 00 00 00 00 00 00 21 23 00 00 00 00 14 
15 15 16 00 00 21 22 22 23 00 00 00 00 00 00 00 00 00 00 00 00 00 00 00 00 00 00 00 00 00 00 00 00 00 00 00 14 
22 22 11 00 00 00 00 00 00 00 00 00 00 00 00 00 00 00 00 00 00 00 07 08 08 09 00 00 00 00 00 00 00 00 00 00 14 
52 52 00 00 00 00 00 00 00 00 00 00 00 00 00 00 00 03 06 00 19 08 20 15 15 17 18 00 00 00 00 00 00 00 00 00 14 
52 52 00 00 00 00 00 00 00 00 00 00 00 00 00 19 08 20 17 08 20 15 15 15 15 15 17 18 00 00 00 00 00 00 00 00 14 
52 52 00 00 00 00 00 00 00 00 00 00 00 00 07 20 15 15 15 15 15 15 15 15 15 15 15 16 00 00 00 00 00 00 00 00 14 
52 52 00 00 00 00 00 00 00 00 00 00 00 00 14 15 15 15 15 15 15 15 15 15 15 15 15 16 00 00 00 00 00 00 00 00 14 
52 52 00 00 00 00 00 00 00 00 00 00 00 19 20 15 15 15 15 15 15 15 15 15 15 15 15 16 00 00 00 00 00 00 00 00 14 
52 52 00 00 00 00 00 00 00 00 00 00 00 14 15 15 15 15 15 15 15 15 15 15 15 15 15 16 00 00 00 00 00 00 00 00 14 
08 08 08 08 08 08 08 08 08 08 08 08 08 20 15 15 15 15 15 15 15 15 15 15 15 15 15 17 08 08 08 08 08 08 08 08 20 

OBJECT_LAYER
distance
/distance

OBJECT_LAYER
background
DEC_seaweed_thick 563 1082
DEC_seaweed_thick 542 1088
DEC_seaweed_thick 643 1081
/background

OBJECT_LAYER
foreground
DEC_Exit 0 1088
DEC_Exit 0 1120
DEC_Exit 0 1152
DEC_Exit 0 1184
DEC_Exit 0 1216
DEC_Exit 0 1248
DEC_fishbones_01 381 318
DEC_fishbones_03 275 713
DEC_starfish_blue 568 842
DEC_starfish_orange 608 574
DEC_starfish_orange 714 1045
DEC_fishbones_01 748 1122
DEC_fishbones_01 980 925
DEC_seaweed_sparse 675 1056
DEC_seaweed_sparse 609 1088
DEC_seaweed_thick 511 1087
DEC_seaweed_thick 752 1024
DEC_seaweed_sparse 455 1120
DEC_seaweed_sparse 788 1024
DEC_seaweed_sparse 929 862
DEC_seaweed_sparse_90 1024 168
DEC_seaweed_thick_90 1014 306
DEC_seaweed_thick_90 1013 342
DEC_seaweed_sparse_270 1118 95
DEC_seaweed_sparse_270 1118 154
DEC_seaweed_sparse_270 1117 241
DEC_seaweed_sparse_270 1116 314
DEC_seaweed_thick 232 204
DEC_seaweed_thick 318 202
DEC_seaweed_thick 355 201
DEC_seaweed_sparse 272 204
DEC_seaweed_sparse 163 222
DEC_seaweed_sparse 422 223
DEC_starfish_blue 899 600
DEC_fishbones_02 304 673
DEC_fishbones_02 640 1237
DEC_fishbones_02 295 285
/foreground

ENEMIES
urchin
point=112,1264

urchin
point=144,1264

urchin
point=176,1264

urchin_180
point=112,1040

urchin_180
point=144,1040

urchin_180
point=176,1072

fish_normal
point=111,1071
point=110,1232
point=111,1072

urchin
point=976,880

urchin
point=1008,880

fish_loops
point=911,1231
point=1137,1230

fish_normal
point=1027,771
point=411,760
point=1028,773

fish_normal
point=813,693
point=406,703
point=815,693

fish_normal
point=1097,560
point=732,563
point=1100,562

urchin_90
point=1073,110

urchin_90
point=1040,147

urchin_90
point=1007,273

urchin_180
point=261,48

urchin_180
point=430,46

urchin_180
point=345,49

urchin_180
point=518,47

urchin_180
point=603,49

urchin_90
point=496,277

urchin_90
point=497,364

fish_normal
point=764,193
point=514,431
point=763,193

fish_normal
point=537,506
point=122,520
point=538,507

fish_normal
point=508,542
point=90,562
point=509,543

/ENEMIES

CATCHERS
CATCHER_blue 118 114
CATCHER_blue 599 208
CATCHER_blue 598 439
CATCHER_blue 835 552
CATCHER_blue 394 554
CATCHER_blue 1085 454
CATCHER_blue 1086 767
CATCHER_blue 817 907
CATCHER_blue 105 668
CATCHER_blue 377 956
CATCHER_blue 318 1167
CATCHER_blue 1004 1143
/CATCHERS

ITEMS
ITEM_sushi2 928 1216
ITEM_sushi2 960 1216
ITEM_sushi2 992 1216
ITEM_sushi2 1024 1216
ITEM_sushi2 1056 1216
ITEM_sushi2 998 1154
ITEM_lightning 1110 47
ITEM_lollipop 1114 51
ITEM_sushi1 213 422
ITEM_sushi2 176 425
ITEM_sushi2 142 426
ITEM_sushi2 108 732
ITEM_sushi2 106 773
ITEM_sushi2 105 817
ITEM_sushi2 105 862
ITEM_sushi1 578 1004
ITEM_sushi2 526 713
ITEM_sushi2 592 720
ITEM_sushi2 672 718
ITEM_sushi2 725 721
ITEM_sushi1 881 463
/ITEMS
