THEME
underground

SIZE
37 34

START
100 100

PLAYER
turtle

PAR_TIME
18

NEXTMAP
coralreef

TERRAIN
15 15 15 15 15 15 15 15 15 15 15 15 15 15 15 15 15 15 15 15 15 15 15 15 15 15 15 15 15 15 15 15 15 15 15 15 15 
15 15 10 22 13 15 15 15 15 15 15 15 15 15 15 15 15 10 22 22 22 22 22 22 22 22 22 22 22 22 13 15 15 15 15 15 15 
15 10 11 00 12 13 15 15 15 15 15 15 15 15 15 15 10 11 00 00 00 00 00 00 00 00 00 00 00 00 24 25 13 15 15 15 15 
15 16 00 00 00 14 15 15 15 15 15 15 15 15 15 10 11 00 00 00 00 00 00 00 00 00 00 00 00 00 00 00 24 25 13 15 15 
15 16 00 00 00 14 15 15 15 15 15 15 15 10 26 27 00 00 00 00 00 00 00 00 00 00 00 00 00 00 00 00 00 00 42 15 15 
15 16 00 00 00 14 15 15 15 10 22 22 26 27 00 00 00 00 00 00 00 00 00 00 00 00 00 00 00 00 00 00 00 00 49 13 15 
15 16 00 00 00 14 15 10 22 11 00 00 00 00 00 00 00 00 00 00 00 03 33 04 08 18 00 00 00 00 00 00 00 00 00 14 15 
15 16 00 00 00 14 15 16 00 00 00 00 00 00 00 00 00 00 00 00 00 14 15 15 15 17 18 00 00 00 00 00 00 00 00 14 15 
15 16 00 00 00 14 15 16 00 00 00 00 00 00 00 00 00 00 00 00 00 14 15 15 15 15 17 18 00 00 00 00 00 00 00 14 15 
15 16 00 00 00 14 15 16 00 00 00 00 00 00 00 00 00 00 00 00 00 14 15 15 15 15 15 17 18 00 00 00 00 00 00 14 15 
15 16 00 00 00 14 15 17 29 00 00 00 00 00 00 00 00 00 00 00 00 14 15 15 15 15 15 15 17 18 00 00 00 00 00 14 15 
15 16 00 00 00 14 15 10 50 00 00 00 00 00 00 00 00 00 00 00 00 14 15 15 15 15 15 15 15 43 00 00 00 00 00 14 15 
15 16 00 00 00 14 15 16 00 00 00 00 00 00 00 00 00 00 00 00 00 14 15 15 15 15 15 15 10 50 00 00 00 00 00 14 15 
15 16 00 00 00 14 15 16 00 00 00 00 00 00 00 00 00 00 00 00 28 20 15 15 15 15 15 15 43 00 00 00 00 00 00 14 15 
15 16 00 00 00 14 15 16 00 00 00 00 00 00 00 00 00 00 00 00 49 13 15 15 15 15 15 10 50 00 00 00 00 00 00 14 15 
15 16 00 00 00 14 15 17 29 00 00 00 00 00 00 00 00 00 00 00 00 14 15 15 15 15 15 43 00 00 00 00 00 00 19 20 15 
15 16 00 00 00 14 15 15 36 00 00 00 00 00 00 00 00 00 00 00 00 14 15 15 15 15 10 50 00 00 00 00 00 19 20 15 15 
15 16 00 00 00 14 15 15 43 00 00 00 00 00 00 00 00 00 00 00 00 14 15 15 15 15 43 00 00 00 00 00 19 20 15 15 15 
15 16 00 00 00 14 15 10 50 00 00 00 00 00 00 00 00 00 00 00 19 20 15 15 15 10 50 00 00 00 00 19 20 15 15 15 15 
15 16 00 00 00 14 15 16 00 00 00 00 00 00 00 00 00 00 00 00 12 13 15 15 15 16 00 00 00 00 19 20 15 15 15 15 15 
15 16 00 00 00 14 15 16 00 00 00 00 00 00 00 00 00 00 00 00 00 14 15 15 15 16 00 00 00 19 20 15 15 15 15 15 15 
15 16 00 00 00 14 15 16 00 00 00 00 00 00 00 00 00 00 00 00 00 14 15 15 15 16 00 00 00 12 13 15 15 15 15 15 15 
15 16 00 00 00 14 15 16 00 00 00 00 00 00 00 00 00 00 00 00 00 14 15 15 15 16 00 00 00 00 12 13 15 15 15 15 15 
15 16 00 00 00 14 15 16 00 00 00 00 00 00 00 00 00 00 00 00 00 14 15 15 15 17 29 00 00 00 00 12 13 15 15 15 15 
15 16 00 00 00 14 15 16 00 00 00 00 00 00 00 00 00 00 00 00 00 14 15 15 15 15 36 00 00 00 00 00 12 13 15 15 15 
15 16 00 00 00 14 15 16 00 00 00 00 00 00 00 00 00 00 00 00 00 14 15 15 15 15 16 00 00 00 00 00 00 12 13 15 15 
15 16 00 00 00 24 30 27 00 00 00 00 00 00 00 00 00 00 00 00 19 20 15 15 15 15 17 29 00 00 00 00 00 00 12 13 15 
15 16 00 00 00 00 00 00 00 00 00 00 00 00 00 00 00 00 00 28 20 15 15 15 15 15 15 36 00 00 00 00 00 00 00 14 15 
15 16 00 00 00 00 00 00 00 00 00 00 00 00 00 00 00 00 00 35 15 15 15 15 15 15 15 17 18 00 00 00 00 00 00 14 15 
15 16 00 00 00 00 00 00 00 00 00 00 00 00 00 00 00 00 19 20 15 15 15 15 15 15 15 15 17 29 00 00 00 00 00 14 15 
15 16 00 00 00 00 00 00 00 00 00 00 00 00 00 00 00 19 20 15 15 15 15 15 15 15 15 15 15 36 00 00 00 00 00 14 15 
15 17 18 00 00 19 05 06 00 00 00 00 00 00 00 03 04 20 15 15 15 15 15 15 15 15 15 15 15 16 00 00 00 00 00 14 15 
15 15 17 08 08 20 15 17 08 08 08 08 08 08 08 20 15 15 15 15 15 15 15 15 15 15 15 15 15 16 00 00 00 00 00 14 15 
15 15 15 15 15 15 15 15 15 15 15 15 15 15 15 15 15 15 15 15 15 15 15 15 15 15 15 15 15 17 52 52 52 52 52 20 15 

OBJECT_LAYER
distance
/distance

OBJECT_LAYER
background
/background

OBJECT_LAYER
foreground
DEC_Exit 960 1056
DEC_Exit 992 1056
DEC_Exit 1024 1056
DEC_Exit 1056 1056
DEC_Exit 1088 1056
/foreground

ENEMIES
bug_blue
point=109,382
point=109,807

bug_blue
point=112,812
point=112,377

bug_yellow
point=463,335
point=513,335
point=329,335
point=462,335

bug_yellow
point=367,367
point=513,367
point=329,367
point=366,367

bug_yellow
point=495,399
point=329,399
point=513,399
point=496,399

bug_yellow
point=379,431
point=513,431
point=329,431
point=378,431

bug_yellow
point=483,463
point=329,463
point=513,463
point=484,463

bug_yellow
point=379,495
point=329,495
point=513,495
point=380,495

bug_yellow
point=495,527
point=329,527
point=513,527
point=496,527

bug_yellow
point=367,559
point=513,559
point=329,559
point=366,559

bug_blue
point=302,679
point=556,772

bug_green
point=579,656
point=329,648
point=503,854
point=581,658

bug_yellow
point=518,802
point=596,681
point=294,662
point=355,812
point=516,803

bug_blue
point=605,723
point=284,775

bug_green
point=327,801
point=500,620
point=586,798
point=328,801

/ENEMIES

CATCHERS
CATCHER_blue 416 288
CATCHER_blue 416 576
CATCHER_blue 416 852
CATCHER_blue 619 127
CATCHER_blue 97 280
CATCHER_blue 971 152
CATCHER_blue 97 498
CATCHER_blue 98 711
CATCHER_blue 130 931
CATCHER_blue 304 955
/CATCHERS

ITEMS
ITEM_carrot 972 798
ITEM_carrot 918 735
ITEM_carrot 869 634
ITEM_carrot 911 574
ITEM_carrot 960 505
ITEM_carrot 1026 407
ITEM_carrot 1046 292
ITEM_carrot 962 208
ITEM_carrot 98 378
ITEM_carrot 101 596
ITEM_carrot 101 791
ITEM_lightning 379 884
ITEM_lightning 416 608
/ITEMS
